,高雄時間,同意票,不同意票,同意比例,有效票,無效票,投票人數,已開投票所投票人總數,投票率,應送行政區,已送行政區,應送開票所,已送開票所,行政區
0,2020-06-06 16:43:50,82692,2486,3.6,85178,520,85698,225014,38.09,38,0,1823,251,高雄市
1,2020-06-06 16:44:50,82692,2486,3.6,85178,520,85698,225014,38.09,38,0,1823,251,高雄市
2,2020-06-06 16:45:51,108484,3255,4.72,111739,676,112415,289386,38.85,38,0,1823,316,高雄市
3,2020-06-06 16:46:51,108484,3255,4.72,111739,676,112415,289386,38.85,38,0,1823,316,高雄市
4,2020-06-06 16:47:51,108484,3255,4.72,111739,676,112415,289386,38.85,38,0,1823,316,高雄市
5,2020-06-06 16:48:51,147193,4345,6.4,151538,904,152442,387528,39.34,38,0,1823,405,高雄市
6,2020-06-06 16:49:52,147193,4345,6.4,151538,904,152442,387528,39.34,38,0,1823,405,高雄市
7,2020-06-06 16:50:52,147193,4345,6.4,151538,904,152442,387528,39.34,38,0,1823,405,高雄市
8,2020-06-06 16:51:52,197253,5742,8.58,202995,1181,204176,513250,39.78,38,0,1823,513,高雄市
9,2020-06-06 16:52:52,197253,5742,8.58,202995,1181,204176,513250,39.78,38,0,1823,513,高雄市
10,2020-06-06 16:53:53,197253,5742,8.58,202995,1181,204176,513250,39.78,38,0,1823,513,高雄市
11,2020-06-06 16:54:53,253511,7337,11.02,260848,1493,262341,653814,40.12,38,0,1823,631,高雄市
12,2020-06-06 16:56:09,5198,116,24.64,5314,37,5351,12182,43.93,1,0,24,15,鹽埕區
13,2020-06-06 16:56:09,5750,138,5.07,5888,34,5922,16011,36.99,1,0,77,15,鼓山區
14,2020-06-06 16:56:09,7689,205,32.44,7894,39,7933,19303,41.1,1,0,22,19,前金區
15,2020-06-06 16:56:09,13359,356,30.78,13715,65,13780,33382,41.28,1,0,42,34,新興區
16,2020-06-06 16:56:09,18363,487,12.12,18850,86,18936,45671,41.46,1,0,99,33,楠梓區
17,2020-06-06 16:56:09,17736,481,11.28,18217,109,18326,44252,41.41,1,0,119,39,前鎮區
18,2020-06-06 16:56:09,253511,7337,11.02,260848,1493,262341,653814,40.12,38,0,1823,631,高雄市
19,2020-06-06 16:56:09,5467,152,22.82,5619,38,5657,12493,45.28,1,0,18,10,旗津區
20,2020-06-06 16:56:09,14168,377,5.04,14545,78,14623,31469,46.47,1,0,189,30,三民區
21,2020-06-06 16:56:09,13226,421,8.36,13647,75,13722,46465,29.53,1,0,103,42,左營區
22,2020-06-06 16:56:09,14897,382,10.44,15279,64,15343,37399,41.03,1,0,116,34,苓雅區
23,2020-06-06 16:56:10,5919,141,6.23,6060,42,6102,15277,39.94,1,0,81,15,大寮區
24,2020-06-06 16:56:10,5926,161,16.59,6087,27,6114,14129,43.27,1,0,32,13,大樹區
25,2020-06-06 16:56:10,6406,210,2.18,6616,32,6648,20402,32.59,1,0,228,19,鳳山區
26,2020-06-06 16:56:10,6562,211,11.39,6773,50,6823,15930,42.83,1,0,51,16,林園區
27,2020-06-06 16:56:10,15329,387,11.83,15716,74,15790,37410,42.21,1,0,89,29,小港區
28,2020-06-06 16:56:11,3241,113,9.95,3354,21,3375,6363,53.04,1,0,31,8,橋頭區
29,2020-06-06 16:56:11,7997,215,27.31,8212,50,8262,17668,46.76,1,0,24,16,大社區
30,2020-06-06 16:56:11,4504,101,11.56,4605,15,4620,10979,42.08,1,0,28,9,鳥松區
31,2020-06-06 16:56:11,4314,141,5.83,4455,18,4473,9864,45.35,1,0,47,8,仁武區
32,2020-06-06 16:56:11,5299,147,20.9,5446,38,5484,12419,44.16,1,0,25,14,燕巢區
33,2020-06-06 16:56:11,8498,252,10.74,8750,49,8799,24062,36.57,1,0,72,24,岡山區
34,2020-06-06 16:56:12,11394,347,26.85,11741,62,11803,26909,43.86,1,0,41,27,路竹區
35,2020-06-06 16:56:12,2186,80,34.02,2266,18,2284,5489,41.61,1,0,12,10,田寮區
36,2020-06-06 16:56:12,7657,223,32.12,7880,53,7933,17261,45.96,1,0,21,16,阿蓮區
37,2020-06-06 16:56:12,5265,176,20.98,5441,36,5477,12097,45.28,1,0,24,12,湖內區
38,2020-06-06 16:56:13,1531,90,14.04,1621,21,1642,6112,26.87,1,0,12,6,六龜區
39,2020-06-06 16:56:13,4789,207,15.55,4996,32,5028,13771,36.51,1,0,35,17,旗山區
40,2020-06-06 16:56:13,6832,209,26.78,7041,38,7079,16803,42.13,1,0,21,14,茄萣區
41,2020-06-06 16:56:13,2347,50,20.06,2397,12,2409,5804,41.51,1,0,12,7,永安區
42,2020-06-06 16:56:13,4508,142,28.32,4650,38,4688,11724,39.99,1,0,18,14,彌陀區
43,2020-06-06 16:56:13,7338,200,24.24,7538,39,7577,15809,47.93,1,0,28,16,梓官區
44,2020-06-06 16:56:13,3769,158,11.05,3927,34,3961,13583,29.16,1,0,32,13,美濃區
45,2020-06-06 16:56:14,91,21,2.72,112,1,113,2051,5.51,1,0,8,5,桃源區
46,2020-06-06 16:56:14,1663,80,16.24,1743,15,1758,6831,25.74,1,0,10,7,杉林區
47,2020-06-06 16:56:14,709,29,13.57,738,6,744,3488,21.33,1,0,7,4,甲仙區
48,2020-06-06 16:56:14,172,5,7.37,177,0,177,1047,16.91,1,0,4,2,那瑪夏區
49,2020-06-06 16:56:14,50,1,3.29,51,0,51,1038,4.91,1,0,3,2,茂林區
50,2020-06-06 16:56:14,3362,125,26.86,3487,47,3534,10867,32.52,1,0,18,17,內門區
51,2020-06-06 16:57:14,6542,152,31.01,6694,43,6737,15237,44.21,1,0,24,18,鹽埕區
52,2020-06-06 16:57:14,301570,8626,13.11,310196,1774,311970,774312,40.29,38,1,1823,731,高雄市
53,2020-06-06 16:57:15,13853,446,8.76,14299,82,14381,47980,29.97,1,0,103,43,左營區
54,2020-06-06 16:57:15,7492,190,6.61,7682,44,7726,20963,36.86,1,0,77,19,鼓山區
55,2020-06-06 16:57:15,22297,594,14.72,22891,107,22998,55976,41.09,1,0,99,40,楠梓區
56,2020-06-06 16:57:16,7689,205,32.44,7894,39,7933,19303,41.1,1,0,22,19,前金區
57,2020-06-06 16:57:16,18381,466,12.88,18847,80,18927,45755,41.37,1,0,116,41,苓雅區
58,2020-06-06 16:57:16,20339,534,12.93,20873,117,20990,50169,41.84,1,0,119,44,前鎮區
59,2020-06-06 16:57:16,18257,462,6.49,18719,95,18814,41392,45.45,1,0,189,37,三民區
60,2020-06-06 16:57:16,15042,391,34.66,15433,72,15505,37385,41.47,1,0,42,37,新興區
61,2020-06-06 16:57:17,8808,277,15.29,9085,70,9155,21128,43.33,1,0,51,21,林園區
62,2020-06-06 16:57:17,18697,465,14.43,19162,94,19256,45557,42.27,1,0,89,35,小港區
63,2020-06-06 16:57:17,5467,152,22.82,5619,38,5657,12493,45.28,1,0,18,10,旗津區
64,2020-06-06 16:57:17,9917,298,3.37,10215,59,10274,32308,31.8,1,0,228,28,鳳山區
65,2020-06-06 16:57:18,8277,214,23.17,8491,37,8528,19881,42.9,1,0,32,18,大樹區
66,2020-06-06 16:57:18,6998,179,7.37,7177,46,7223,18040,40.04,1,0,81,18,大寮區
67,2020-06-06 16:57:19,9243,254,31.57,9497,59,9556,20341,46.98,1,0,24,18,大社區
68,2020-06-06 16:57:19,5577,168,7.54,5745,27,5772,12845,44.94,1,0,47,10,仁武區
69,2020-06-06 16:57:19,6171,145,15.84,6316,26,6342,14688,43.18,1,0,28,12,鳥松區
70,2020-06-06 16:57:20,8851,263,11.19,9114,50,9164,24811,36.94,1,0,72,25,岡山區
71,2020-06-06 16:57:20,4396,150,13.49,4546,26,4572,8662,52.78,1,0,31,10,橋頭區
72,2020-06-06 16:57:21,8754,247,36.72,9001,58,9059,19891,45.54,1,0,21,18,阿蓮區
73,2020-06-06 16:57:21,7249,193,28.59,7442,55,7497,17168,43.67,1,0,25,18,燕巢區
74,2020-06-06 16:57:21,2475,91,38.52,2566,21,2587,6067,42.64,1,0,12,11,田寮區
75,2020-06-06 16:57:22,12265,370,28.91,12635,67,12702,28933,43.9,1,0,41,29,路竹區
76,2020-06-06 16:57:22,5688,198,22.66,5886,36,5922,13292,44.55,1,0,24,13,湖內區
77,2020-06-06 16:57:22,8767,264,34.36,9031,49,9080,21028,43.18,1,0,21,18,茄萣區
78,2020-06-06 16:57:23,4789,207,15.55,4996,32,5028,13771,36.51,1,0,35,17,旗山區
79,2020-06-06 16:57:23,2976,72,25.44,3048,18,3066,7243,42.33,1,0,12,9,永安區
80,2020-06-06 16:57:23,8714,233,28.79,8947,47,8994,18803,47.83,1,0,28,18,梓官區
81,2020-06-06 16:57:23,4508,142,28.32,4650,38,4688,11724,39.99,1,0,18,14,彌陀區
82,2020-06-06 16:57:24,887,44,16.98,931,8,939,4072,23.06,1,0,7,5,甲仙區
83,2020-06-06 16:57:24,1729,105,15.86,1834,23,1857,6732,27.58,1,0,12,7,六龜區
84,2020-06-06 16:57:24,4289,189,12.57,4478,39,4517,15510,29.12,1,0,32,15,美濃區
85,2020-06-06 16:57:25,50,1,3.29,51,0,51,1038,4.91,1,0,3,2,茂林區
86,2020-06-06 16:57:25,91,21,2.72,112,1,113,2051,5.51,1,0,8,5,桃源區
87,2020-06-06 16:57:25,3863,145,30.86,4008,56,4064,12517,32.47,1,1,18,18,內門區
88,2020-06-06 16:57:25,193,6,8.27,199,0,199,1755,11.34,1,0,4,3,那瑪夏區
89,2020-06-06 16:57:25,1989,93,19.43,2082,15,2097,7803,26.87,1,0,10,8,杉林區
90,2020-06-06 16:57:41,301570,8626,13.11,310196,1774,311970,774312,40.29,38,1,1823,731,高雄市
91,2020-06-06 16:57:41,22297,594,14.72,22891,107,22998,55976,41.09,1,0,99,40,楠梓區
92,2020-06-06 16:57:41,15042,391,34.66,15433,72,15505,37385,41.47,1,0,42,37,新興區
93,2020-06-06 16:57:41,7689,205,32.44,7894,39,7933,19303,41.1,1,0,22,19,前金區
94,2020-06-06 16:57:41,7492,190,6.61,7682,44,7726,20963,36.86,1,0,77,19,鼓山區
95,2020-06-06 16:57:41,13853,446,8.76,14299,82,14381,47980,29.97,1,0,103,43,左營區
96,2020-06-06 16:57:41,6542,152,31.01,6694,43,6737,15237,44.21,1,0,24,18,鹽埕區
97,2020-06-06 16:57:41,18257,462,6.49,18719,95,18814,41392,45.45,1,0,189,37,三民區
98,2020-06-06 16:57:42,4396,150,13.49,4546,26,4572,8662,52.78,1,0,31,10,橋頭區
99,2020-06-06 16:57:42,6998,179,7.37,7177,46,7223,18040,40.04,1,0,81,18,大寮區
100,2020-06-06 16:57:42,18381,466,12.88,18847,80,18927,45755,41.37,1,0,116,41,苓雅區
101,2020-06-06 16:57:42,6171,145,15.84,6316,26,6342,14688,43.18,1,0,28,12,鳥松區
102,2020-06-06 16:57:42,18697,465,14.43,19162,94,19256,45557,42.27,1,0,89,35,小港區
103,2020-06-06 16:57:42,9243,254,31.57,9497,59,9556,20341,46.98,1,0,24,18,大社區
104,2020-06-06 16:57:42,5467,152,22.82,5619,38,5657,12493,45.28,1,0,18,10,旗津區
105,2020-06-06 16:57:42,5577,168,7.54,5745,27,5772,12845,44.94,1,0,47,10,仁武區
106,2020-06-06 16:57:42,9917,298,3.37,10215,59,10274,32308,31.8,1,0,228,28,鳳山區
107,2020-06-06 16:57:42,8851,263,11.19,9114,50,9164,24811,36.94,1,0,72,25,岡山區
108,2020-06-06 16:57:42,20339,534,12.93,20873,117,20990,50169,41.84,1,0,119,44,前鎮區
109,2020-06-06 16:57:42,8277,214,23.17,8491,37,8528,19881,42.9,1,0,32,18,大樹區
110,2020-06-06 16:57:42,8808,277,15.29,9085,70,9155,21128,43.33,1,0,51,21,林園區
111,2020-06-06 16:57:43,4289,189,12.57,4478,39,4517,15510,29.12,1,0,32,15,美濃區
112,2020-06-06 16:57:43,7249,193,28.59,7442,55,7497,17168,43.67,1,0,25,18,燕巢區
113,2020-06-06 16:57:43,8754,247,36.72,9001,58,9059,19891,45.54,1,0,21,18,阿蓮區
114,2020-06-06 16:57:43,12265,370,28.91,12635,67,12702,28933,43.9,1,0,41,29,路竹區
115,2020-06-06 16:57:43,2976,72,25.44,3048,18,3066,7243,42.33,1,0,12,9,永安區
116,2020-06-06 16:57:43,8714,233,28.79,8947,47,8994,18803,47.83,1,0,28,18,梓官區
117,2020-06-06 16:57:43,2475,91,38.52,2566,21,2587,6067,42.64,1,0,12,11,田寮區
118,2020-06-06 16:57:43,4789,207,15.55,4996,32,5028,13771,36.51,1,0,35,17,旗山區
119,2020-06-06 16:57:43,887,44,16.98,931,8,939,4072,23.06,1,0,7,5,甲仙區
120,2020-06-06 16:57:43,1989,93,19.43,2082,15,2097,7803,26.87,1,0,10,8,杉林區
121,2020-06-06 16:57:43,4508,142,28.32,4650,38,4688,11724,39.99,1,0,18,14,彌陀區
122,2020-06-06 16:57:43,8767,264,34.36,9031,49,9080,21028,43.18,1,0,21,18,茄萣區
123,2020-06-06 16:57:43,1729,105,15.86,1834,23,1857,6732,27.58,1,0,12,7,六龜區
124,2020-06-06 16:57:43,5688,198,22.66,5886,36,5922,13292,44.55,1,0,24,13,湖內區
125,2020-06-06 16:57:44,3863,145,30.86,4008,56,4064,12517,32.47,1,1,18,18,內門區
126,2020-06-06 16:57:44,50,1,3.29,51,0,51,1038,4.91,1,0,3,2,茂林區
127,2020-06-06 16:57:44,91,21,2.72,112,1,113,2051,5.51,1,0,8,5,桃源區
128,2020-06-06 16:57:44,193,6,8.27,199,0,199,1755,11.34,1,0,4,3,那瑪夏區
129,2020-06-06 16:58:34,301570,8626,13.11,310196,1774,311970,774312,40.29,38,1,1823,731,高雄市
130,2020-06-06 16:58:35,7492,190,6.61,7682,44,7726,20963,36.86,1,0,77,19,鼓山區
131,2020-06-06 16:58:35,6542,152,31.01,6694,43,6737,15237,44.21,1,0,24,18,鹽埕區
132,2020-06-06 16:58:35,22297,594,14.72,22891,107,22998,55976,41.09,1,0,99,40,楠梓區
133,2020-06-06 16:58:35,13853,446,8.76,14299,82,14381,47980,29.97,1,0,103,43,左營區
134,2020-06-06 16:58:35,18257,462,6.49,18719,95,18814,41392,45.45,1,0,189,37,三民區
135,2020-06-06 16:58:36,7689,205,32.44,7894,39,7933,19303,41.1,1,0,22,19,前金區
136,2020-06-06 16:58:36,5467,152,22.82,5619,38,5657,12493,45.28,1,0,18,10,旗津區
137,2020-06-06 16:58:36,18381,466,12.88,18847,80,18927,45755,41.37,1,0,116,41,苓雅區
138,2020-06-06 16:58:36,15042,391,34.66,15433,72,15505,37385,41.47,1,0,42,37,新興區
139,2020-06-06 16:58:36,20339,534,12.93,20873,117,20990,50169,41.84,1,0,119,44,前鎮區
140,2020-06-06 16:58:37,8277,214,23.17,8491,37,8528,19881,42.9,1,0,32,18,大樹區
141,2020-06-06 16:58:37,6998,179,7.37,7177,46,7223,18040,40.04,1,0,81,18,大寮區
142,2020-06-06 16:58:37,9243,254,31.57,9497,59,9556,20341,46.98,1,0,24,18,大社區
143,2020-06-06 16:58:37,9917,298,3.37,10215,59,10274,32308,31.8,1,0,228,28,鳳山區
144,2020-06-06 16:58:37,18697,465,14.43,19162,94,19256,45557,42.27,1,0,89,35,小港區
145,2020-06-06 16:58:37,8808,277,15.29,9085,70,9155,21128,43.33,1,0,51,21,林園區
146,2020-06-06 16:58:38,5577,168,7.54,5745,27,5772,12845,44.94,1,0,47,10,仁武區
147,2020-06-06 16:58:38,6171,145,15.84,6316,26,6342,14688,43.18,1,0,28,12,鳥松區
148,2020-06-06 16:58:38,4396,150,13.49,4546,26,4572,8662,52.78,1,0,31,10,橋頭區
149,2020-06-06 16:58:38,8851,263,11.19,9114,50,9164,24811,36.94,1,0,72,25,岡山區
150,2020-06-06 16:58:38,7249,193,28.59,7442,55,7497,17168,43.67,1,0,25,18,燕巢區
151,2020-06-06 16:58:39,2475,91,38.52,2566,21,2587,6067,42.64,1,0,12,11,田寮區
152,2020-06-06 16:58:39,8754,247,36.72,9001,58,9059,19891,45.54,1,0,21,18,阿蓮區
153,2020-06-06 16:58:39,12265,370,28.91,12635,67,12702,28933,43.9,1,0,41,29,路竹區
154,2020-06-06 16:58:40,5688,198,22.66,5886,36,5922,13292,44.55,1,0,24,13,湖內區
155,2020-06-06 16:58:40,4789,207,15.55,4996,32,5028,13771,36.51,1,0,35,17,旗山區
156,2020-06-06 16:58:40,2976,72,25.44,3048,18,3066,7243,42.33,1,0,12,9,永安區
157,2020-06-06 16:58:40,8767,264,34.36,9031,49,9080,21028,43.18,1,0,21,18,茄萣區
158,2020-06-06 16:58:40,4508,142,28.32,4650,38,4688,11724,39.99,1,0,18,14,彌陀區
159,2020-06-06 16:58:40,8714,233,28.79,8947,47,8994,18803,47.83,1,0,28,18,梓官區
160,2020-06-06 16:58:41,1989,93,19.43,2082,15,2097,7803,26.87,1,0,10,8,杉林區
161,2020-06-06 16:58:41,1729,105,15.86,1834,23,1857,6732,27.58,1,0,12,7,六龜區
162,2020-06-06 16:58:41,3863,145,30.86,4008,56,4064,12517,32.47,1,1,18,18,內門區
163,2020-06-06 16:58:41,887,44,16.98,931,8,939,4072,23.06,1,0,7,5,甲仙區
164,2020-06-06 16:58:41,4289,189,12.57,4478,39,4517,15510,29.12,1,0,32,15,美濃區
165,2020-06-06 16:58:42,91,21,2.72,112,1,113,2051,5.51,1,0,8,5,桃源區
166,2020-06-06 16:58:42,193,6,8.27,199,0,199,1755,11.34,1,0,4,3,那瑪夏區
167,2020-06-06 16:58:42,50,1,3.29,51,0,51,1038,4.91,1,0,3,2,茂林區
168,2020-06-06 16:59:32,6542,152,31.01,6694,43,6737,15237,44.21,1,0,24,18,鹽埕區
169,2020-06-06 16:59:32,301570,8626,13.11,310196,1774,311970,774312,40.29,38,1,1823,731,高雄市
170,2020-06-06 16:59:33,7689,205,32.44,7894,39,7933,19303,41.1,1,0,22,19,前金區
171,2020-06-06 16:59:33,7492,190,6.61,7682,44,7726,20963,36.86,1,0,77,19,鼓山區
172,2020-06-06 16:59:33,18257,462,6.49,18719,95,18814,41392,45.45,1,0,189,37,三民區
173,2020-06-06 16:59:33,22297,594,14.72,22891,107,22998,55976,41.09,1,0,99,40,楠梓區
174,2020-06-06 16:59:33,15042,391,34.66,15433,72,15505,37385,41.47,1,0,42,37,新興區
175,2020-06-06 16:59:33,13853,446,8.76,14299,82,14381,47980,29.97,1,0,103,43,左營區
176,2020-06-06 16:59:34,5467,152,22.82,5619,38,5657,12493,45.28,1,0,18,10,旗津區
177,2020-06-06 16:59:34,20339,534,12.93,20873,117,20990,50169,41.84,1,0,119,44,前鎮區
178,2020-06-06 16:59:34,18697,465,14.43,19162,94,19256,45557,42.27,1,0,89,35,小港區
179,2020-06-06 16:59:34,18381,466,12.88,18847,80,18927,45755,41.37,1,0,116,41,苓雅區
180,2020-06-06 16:59:35,9917,298,3.37,10215,59,10274,32308,31.8,1,0,228,28,鳳山區
181,2020-06-06 16:59:35,6998,179,7.37,7177,46,7223,18040,40.04,1,0,81,18,大寮區
182,2020-06-06 16:59:35,8808,277,15.29,9085,70,9155,21128,43.33,1,0,51,21,林園區
183,2020-06-06 16:59:35,8277,214,23.17,8491,37,8528,19881,42.9,1,0,32,18,大樹區
184,2020-06-06 16:59:36,8851,263,11.19,9114,50,9164,24811,36.94,1,0,72,25,岡山區
185,2020-06-06 16:59:36,5577,168,7.54,5745,27,5772,12845,44.94,1,0,47,10,仁武區
186,2020-06-06 16:59:36,6171,145,15.84,6316,26,6342,14688,43.18,1,0,28,12,鳥松區
187,2020-06-06 16:59:36,9243,254,31.57,9497,59,9556,20341,46.98,1,0,24,18,大社區
188,2020-06-06 16:59:37,1729,105,15.86,1834,23,1857,6732,27.58,1,0,12,7,六龜區
189,2020-06-06 16:59:37,8754,247,36.72,9001,58,9059,19891,45.54,1,0,21,18,阿蓮區
190,2020-06-06 16:59:37,8714,233,28.79,8947,47,8994,18803,47.83,1,0,28,18,梓官區
191,2020-06-06 16:59:37,4396,150,13.49,4546,26,4572,8662,52.78,1,0,31,10,橋頭區
192,2020-06-06 16:59:37,887,44,16.98,931,8,939,4072,23.06,1,0,7,5,甲仙區
193,2020-06-06 16:59:37,4289,189,12.57,4478,39,4517,15510,29.12,1,0,32,15,美濃區
194,2020-06-06 16:59:37,7249,193,28.59,7442,55,7497,17168,43.67,1,0,25,18,燕巢區
195,2020-06-06 16:59:37,5688,198,22.66,5886,36,5922,13292,44.55,1,0,24,13,湖內區
196,2020-06-06 16:59:37,8767,264,34.36,9031,49,9080,21028,43.18,1,0,21,18,茄萣區
197,2020-06-06 16:59:37,4508,142,28.32,4650,38,4688,11724,39.99,1,0,18,14,彌陀區
198,2020-06-06 16:59:37,1989,93,19.43,2082,15,2097,7803,26.87,1,0,10,8,杉林區
199,2020-06-06 16:59:37,2475,91,38.52,2566,21,2587,6067,42.64,1,0,12,11,田寮區
200,2020-06-06 16:59:37,4789,207,15.55,4996,32,5028,13771,36.51,1,0,35,17,旗山區
201,2020-06-06 16:59:37,12265,370,28.91,12635,67,12702,28933,43.9,1,0,41,29,路竹區
202,2020-06-06 16:59:37,2976,72,25.44,3048,18,3066,7243,42.33,1,0,12,9,永安區
203,2020-06-06 16:59:38,3863,145,30.86,4008,56,4064,12517,32.47,1,1,18,18,內門區
204,2020-06-06 16:59:38,91,21,2.72,112,1,113,2051,5.51,1,0,8,5,桃源區
205,2020-06-06 16:59:38,50,1,3.29,51,0,51,1038,4.91,1,0,3,2,茂林區
206,2020-06-06 16:59:38,193,6,8.27,199,0,199,1755,11.34,1,0,4,3,那瑪夏區
207,2020-06-06 17:00:29,15961,415,36.78,16376,80,16456,39748,41.4,1,0,42,39,新興區
208,2020-06-06 17:00:29,18458,559,11.67,19017,101,19118,60259,31.73,1,0,103,50,左營區
209,2020-06-06 17:00:29,25847,697,16.43,26544,140,26684,62828,42.47,1,0,119,55,前鎮區
210,2020-06-06 17:00:29,10288,264,9.07,10552,53,10605,27505,38.56,1,0,77,24,鼓山區
211,2020-06-06 17:00:29,21595,552,15.13,22147,100,22247,53420,41.65,1,0,116,48,苓雅區
212,2020-06-06 17:00:29,25406,653,9.03,26059,124,26183,58147,45.03,1,0,189,49,三民區
213,2020-06-06 17:00:29,7566,189,35.87,7755,51,7806,17603,44.34,1,0,24,21,鹽埕區
214,2020-06-06 17:00:29,24926,658,16.45,25584,118,25702,62464,41.15,1,0,99,44,楠梓區
215,2020-06-06 17:00:29,363516,10364,15.81,373880,2115,375995,925521,40.63,38,3,1823,856,高雄市
216,2020-06-06 17:00:29,8714,235,36.76,8949,45,8994,21939,41.0,1,0,22,21,前金區
217,2020-06-06 17:00:30,15928,446,5.42,16374,90,16464,47629,34.57,1,0,228,41,鳳山區
218,2020-06-06 17:00:30,9765,260,27.34,10025,51,10076,22970,43.87,1,0,32,21,大樹區
219,2020-06-06 17:00:30,6184,165,25.82,6349,40,6389,14044,45.49,1,0,18,11,旗津區
220,2020-06-06 17:00:30,21978,546,16.96,22524,110,22634,54053,41.87,1,0,89,41,小港區
221,2020-06-06 17:00:30,6998,179,7.37,7177,46,7223,18040,40.04,1,0,81,18,大寮區
222,2020-06-06 17:00:30,11176,336,19.4,11512,80,11592,26372,43.96,1,0,51,26,林園區
223,2020-06-06 17:00:31,9243,254,31.57,9497,59,9556,20341,46.98,1,0,24,18,大社區
224,2020-06-06 17:00:31,8122,187,20.85,8309,34,8343,19409,42.99,1,0,28,15,鳥松區
225,2020-06-06 17:00:31,8273,245,11.18,8518,44,8562,18647,45.92,1,0,47,14,仁武區
226,2020-06-06 17:00:32,7414,265,29.54,7679,49,7728,17155,45.05,1,0,24,17,湖內區
227,2020-06-06 17:00:32,6271,213,19.25,6484,36,6520,12599,51.75,1,0,31,14,橋頭區
228,2020-06-06 17:00:32,9305,258,39.03,9563,64,9627,21083,45.66,1,0,21,19,阿蓮區
229,2020-06-06 17:00:32,2475,91,38.52,2566,21,2587,6067,42.64,1,0,12,11,田寮區
230,2020-06-06 17:00:32,11455,357,14.48,11812,59,11871,31788,37.34,1,0,72,31,岡山區
231,2020-06-06 17:00:32,8740,238,34.47,8978,74,9052,20783,43.55,1,0,25,21,燕巢區
232,2020-06-06 17:00:32,14297,439,33.69,14736,88,14824,33828,43.82,1,0,41,34,路竹區
233,2020-06-06 17:00:33,9499,279,37.23,9778,51,9829,22764,43.18,1,0,21,19,茄萣區
234,2020-06-06 17:00:33,2976,72,25.44,3048,18,3066,7243,42.33,1,0,12,9,永安區
235,2020-06-06 17:00:33,5319,164,33.42,5483,40,5523,13866,39.83,1,0,18,16,彌陀區
236,2020-06-06 17:00:34,6049,254,19.64,6303,42,6345,17174,36.95,1,0,35,21,旗山區
237,2020-06-06 17:00:34,2048,126,18.78,2174,30,2204,8062,27.34,1,0,12,8,六龜區
238,2020-06-06 17:00:34,4289,189,12.57,4478,39,4517,15510,29.12,1,0,32,15,美濃區
239,2020-06-06 17:00:34,887,44,16.98,931,8,939,4072,23.06,1,0,7,5,甲仙區
240,2020-06-06 17:00:34,9764,265,32.25,10029,57,10086,21044,47.93,1,0,28,20,梓官區
241,2020-06-06 17:00:34,1989,93,19.43,2082,15,2097,7803,26.87,1,0,10,8,杉林區
242,2020-06-06 17:00:35,60,1,3.95,61,0,61,1520,4.01,1,1,3,3,茂林區
243,2020-06-06 17:00:35,3863,145,30.86,4008,56,4064,12517,32.47,1,1,18,18,內門區
244,2020-06-06 17:00:36,209,7,8.95,216,0,216,2334,9.25,1,1,4,4,那瑪夏區
245,2020-06-06 17:00:36,179,24,5.36,203,2,205,2891,7.09,1,0,8,7,桃源區
246,2020-06-06 17:01:26,7566,189,35.87,7755,51,7806,17603,44.34,1,0,24,21,鹽埕區
247,2020-06-06 17:01:26,15961,415,36.78,16376,80,16456,39748,41.4,1,0,42,39,新興區
248,2020-06-06 17:01:26,25406,653,9.03,26059,124,26183,58147,45.03,1,0,189,49,三民區
249,2020-06-06 17:01:26,10288,264,9.07,10552,53,10605,27505,38.56,1,0,77,24,鼓山區
250,2020-06-06 17:01:26,8714,235,36.76,8949,45,8994,21939,41.0,1,0,22,21,前金區
251,2020-06-06 17:01:26,18458,559,11.67,19017,101,19118,60259,31.73,1,0,103,50,左營區
252,2020-06-06 17:01:26,24926,658,16.45,25584,118,25702,62464,41.15,1,0,99,44,楠梓區
253,2020-06-06 17:01:26,363516,10364,15.81,373880,2115,375995,925521,40.63,38,3,1823,856,高雄市
254,2020-06-06 17:01:27,6184,165,25.82,6349,40,6389,14044,45.49,1,0,18,11,旗津區
255,2020-06-06 17:01:27,25847,697,16.43,26544,140,26684,62828,42.47,1,0,119,55,前鎮區
256,2020-06-06 17:01:27,21595,552,15.13,22147,100,22247,53420,41.65,1,0,116,48,苓雅區
257,2020-06-06 17:01:27,15928,446,5.42,16374,90,16464,47629,34.57,1,0,228,41,鳳山區
258,2020-06-06 17:01:27,21978,546,16.96,22524,110,22634,54053,41.87,1,0,89,41,小港區
259,2020-06-06 17:01:28,9243,254,31.57,9497,59,9556,20341,46.98,1,0,24,18,大社區
260,2020-06-06 17:01:28,6998,179,7.37,7177,46,7223,18040,40.04,1,0,81,18,大寮區
261,2020-06-06 17:01:28,8122,187,20.85,8309,34,8343,19409,42.99,1,0,28,15,鳥松區
262,2020-06-06 17:01:28,11455,357,14.48,11812,59,11871,31788,37.34,1,0,72,31,岡山區
263,2020-06-06 17:01:28,11176,336,19.4,11512,80,11592,26372,43.96,1,0,51,26,林園區
264,2020-06-06 17:01:28,9765,260,27.34,10025,51,10076,22970,43.87,1,0,32,21,大樹區
265,2020-06-06 17:01:28,6271,213,19.25,6484,36,6520,12599,51.75,1,0,31,14,橋頭區
266,2020-06-06 17:01:28,8273,245,11.18,8518,44,8562,18647,45.92,1,0,47,14,仁武區
267,2020-06-06 17:01:29,8740,238,34.47,8978,74,9052,20783,43.55,1,0,25,21,燕巢區
268,2020-06-06 17:01:29,14297,439,33.69,14736,88,14824,33828,43.82,1,0,41,34,路竹區
269,2020-06-06 17:01:29,2475,91,38.52,2566,21,2587,6067,42.64,1,0,12,11,田寮區
270,2020-06-06 17:01:29,9305,258,39.03,9563,64,9627,21083,45.66,1,0,21,19,阿蓮區
271,2020-06-06 17:01:30,2976,72,25.44,3048,18,3066,7243,42.33,1,0,12,9,永安區
272,2020-06-06 17:01:30,7414,265,29.54,7679,49,7728,17155,45.05,1,0,24,17,湖內區
273,2020-06-06 17:01:30,9499,279,37.23,9778,51,9829,22764,43.18,1,0,21,19,茄萣區
274,2020-06-06 17:01:31,2048,126,18.78,2174,30,2204,8062,27.34,1,0,12,8,六龜區
275,2020-06-06 17:01:31,5319,164,33.42,5483,40,5523,13866,39.83,1,0,18,16,彌陀區
276,2020-06-06 17:01:31,6049,254,19.64,6303,42,6345,17174,36.95,1,0,35,21,旗山區
277,2020-06-06 17:01:31,4289,189,12.57,4478,39,4517,15510,29.12,1,0,32,15,美濃區
278,2020-06-06 17:01:31,9764,265,32.25,10029,57,10086,21044,47.93,1,0,28,20,梓官區
279,2020-06-06 17:01:32,209,7,8.95,216,0,216,2334,9.25,1,1,4,4,那瑪夏區
280,2020-06-06 17:01:32,1989,93,19.43,2082,15,2097,7803,26.87,1,0,10,8,杉林區
281,2020-06-06 17:01:32,60,1,3.95,61,0,61,1520,4.01,1,1,3,3,茂林區
282,2020-06-06 17:01:32,3863,145,30.86,4008,56,4064,12517,32.47,1,1,18,18,內門區
283,2020-06-06 17:01:32,887,44,16.98,931,8,939,4072,23.06,1,0,7,5,甲仙區
284,2020-06-06 17:01:32,179,24,5.36,203,2,205,2891,7.09,1,0,8,7,桃源區
285,2020-06-06 17:02:22,363516,10364,15.81,373880,2115,375995,925521,40.63,38,3,1823,856,高雄市
286,2020-06-06 17:02:22,7566,189,35.87,7755,51,7806,17603,44.34,1,0,24,21,鹽埕區
287,2020-06-06 17:02:23,21978,546,16.96,22524,110,22634,54053,41.87,1,0,89,41,小港區
288,2020-06-06 17:02:23,25847,697,16.43,26544,140,26684,62828,42.47,1,0,119,55,前鎮區
289,2020-06-06 17:02:23,24926,658,16.45,25584,118,25702,62464,41.15,1,0,99,44,楠梓區
290,2020-06-06 17:02:23,10288,264,9.07,10552,53,10605,27505,38.56,1,0,77,24,鼓山區
291,2020-06-06 17:02:23,8714,235,36.76,8949,45,8994,21939,41.0,1,0,22,21,前金區
292,2020-06-06 17:02:23,6184,165,25.82,6349,40,6389,14044,45.49,1,0,18,11,旗津區
293,2020-06-06 17:02:23,25406,653,9.03,26059,124,26183,58147,45.03,1,0,189,49,三民區
294,2020-06-06 17:02:23,21595,552,15.13,22147,100,22247,53420,41.65,1,0,116,48,苓雅區
295,2020-06-06 17:02:23,15961,415,36.78,16376,80,16456,39748,41.4,1,0,42,39,新興區
296,2020-06-06 17:02:23,15928,446,5.42,16374,90,16464,47629,34.57,1,0,228,41,鳳山區
297,2020-06-06 17:02:23,18458,559,11.67,19017,101,19118,60259,31.73,1,0,103,50,左營區
298,2020-06-06 17:02:24,11455,357,14.48,11812,59,11871,31788,37.34,1,0,72,31,岡山區
299,2020-06-06 17:02:24,11176,336,19.4,11512,80,11592,26372,43.96,1,0,51,26,林園區
300,2020-06-06 17:02:24,14297,439,33.69,14736,88,14824,33828,43.82,1,0,41,34,路竹區
301,2020-06-06 17:02:24,8122,187,20.85,8309,34,8343,19409,42.99,1,0,28,15,鳥松區
302,2020-06-06 17:02:24,8273,245,11.18,8518,44,8562,18647,45.92,1,0,47,14,仁武區
303,2020-06-06 17:02:24,9765,260,27.34,10025,51,10076,22970,43.87,1,0,32,21,大樹區
304,2020-06-06 17:02:24,2475,91,38.52,2566,21,2587,6067,42.64,1,0,12,11,田寮區
305,2020-06-06 17:02:24,8740,238,34.47,8978,74,9052,20783,43.55,1,0,25,21,燕巢區
306,2020-06-06 17:02:24,6998,179,7.37,7177,46,7223,18040,40.04,1,0,81,18,大寮區
307,2020-06-06 17:02:24,9243,254,31.57,9497,59,9556,20341,46.98,1,0,24,18,大社區
308,2020-06-06 17:02:24,6271,213,19.25,6484,36,6520,12599,51.75,1,0,31,14,橋頭區
309,2020-06-06 17:02:24,9305,258,39.03,9563,64,9627,21083,45.66,1,0,21,19,阿蓮區
310,2020-06-06 17:02:25,2048,126,18.78,2174,30,2204,8062,27.34,1,0,12,8,六龜區
311,2020-06-06 17:02:25,9764,265,32.25,10029,57,10086,21044,47.93,1,0,28,20,梓官區
312,2020-06-06 17:02:25,9499,279,37.23,9778,51,9829,22764,43.18,1,0,21,19,茄萣區
313,2020-06-06 17:02:25,7414,265,29.54,7679,49,7728,17155,45.05,1,0,24,17,湖內區
314,2020-06-06 17:02:25,887,44,16.98,931,8,939,4072,23.06,1,0,7,5,甲仙區
315,2020-06-06 17:02:25,1989,93,19.43,2082,15,2097,7803,26.87,1,0,10,8,杉林區
316,2020-06-06 17:02:25,4289,189,12.57,4478,39,4517,15510,29.12,1,0,32,15,美濃區
317,2020-06-06 17:02:25,5319,164,33.42,5483,40,5523,13866,39.83,1,0,18,16,彌陀區
318,2020-06-06 17:02:25,2976,72,25.44,3048,18,3066,7243,42.33,1,0,12,9,永安區
319,2020-06-06 17:02:25,6049,254,19.64,6303,42,6345,17174,36.95,1,0,35,21,旗山區
320,2020-06-06 17:02:26,60,1,3.95,61,0,61,1520,4.01,1,1,3,3,茂林區
321,2020-06-06 17:02:26,3863,145,30.86,4008,56,4064,12517,32.47,1,1,18,18,內門區
322,2020-06-06 17:02:26,209,7,8.95,216,0,216,2334,9.25,1,1,4,4,那瑪夏區
323,2020-06-06 17:02:26,179,24,5.36,203,2,205,2891,7.09,1,0,8,7,桃源區
324,2020-06-06 17:03:16,427983,12036,18.61,440019,2463,442482,1077168,41.08,38,5,1823,972,高雄市
325,2020-06-06 17:03:17,28589,744,18.87,29333,135,29468,71392,41.28,1,0,99,50,楠梓區
326,2020-06-06 17:03:17,32437,820,11.53,33257,167,33424,74773,44.7,1,0,189,61,三民區
327,2020-06-06 17:03:17,12964,335,11.43,13299,63,13362,34132,39.15,1,0,77,29,鼓山區
328,2020-06-06 17:03:17,21191,620,13.4,21811,118,21929,67405,32.53,1,0,103,54,左營區
329,2020-06-06 17:03:17,8634,213,40.93,8847,56,8903,19983,44.55,1,0,24,23,鹽埕區
330,2020-06-06 17:03:18,7065,186,29.49,7251,46,7297,15986,45.65,1,0,18,13,旗津區
331,2020-06-06 17:03:18,20759,570,7.06,21329,112,21441,59854,35.82,1,0,228,51,鳳山區
332,2020-06-06 17:03:18,26724,685,20.62,27409,130,27539,64808,42.49,1,0,89,48,小港區
333,2020-06-06 17:03:18,16927,431,39.01,17358,91,17449,42092,41.45,1,0,42,41,新興區
334,2020-06-06 17:03:18,9437,252,39.81,9689,47,9736,23704,41.07,1,1,22,22,前金區
335,2020-06-06 17:03:18,13221,391,22.95,13612,99,13711,30880,44.4,1,0,51,30,林園區
336,2020-06-06 17:03:18,30739,822,19.54,31561,167,31728,73802,42.99,1,0,119,63,前鎮區
337,2020-06-06 17:03:18,26850,681,18.81,27531,130,27661,66015,41.9,1,0,116,59,苓雅區
338,2020-06-06 17:03:19,8941,230,9.41,9171,54,9225,23314,39.57,1,0,81,22,大寮區
339,2020-06-06 17:03:19,10017,280,34.21,10297,63,10360,21998,47.1,1,0,24,19,大社區
340,2020-06-06 17:03:19,10903,286,30.52,11189,56,11245,25569,43.98,1,0,32,23,大樹區
341,2020-06-06 17:03:19,10186,230,26.14,10416,46,10462,24191,43.25,1,0,28,18,鳥松區
342,2020-06-06 17:03:19,12885,352,17.42,13237,66,13303,28604,46.51,1,0,47,20,仁武區
343,2020-06-06 17:03:20,8113,264,24.9,8377,46,8423,16108,52.29,1,0,31,17,橋頭區
344,2020-06-06 17:03:20,15114,452,19.1,15566,69,15635,40036,39.05,1,0,72,38,岡山區
345,2020-06-06 17:03:21,2475,91,38.52,2566,21,2587,6067,42.64,1,0,12,11,田寮區
346,2020-06-06 17:03:21,9305,258,39.03,9563,64,9627,21083,45.66,1,0,21,19,阿蓮區
347,2020-06-06 17:03:21,9263,251,36.53,9514,78,9592,22050,43.5,1,0,25,22,燕巢區
348,2020-06-06 17:03:21,16315,515,38.45,16830,101,16931,38443,44.04,1,0,41,38,路竹區
349,2020-06-06 17:03:22,3420,82,29.23,3502,19,3521,8416,41.84,1,0,12,10,永安區
350,2020-06-06 17:03:22,8293,287,33.04,8580,57,8637,19200,44.98,1,0,24,19,湖內區
351,2020-06-06 17:03:22,4289,189,12.57,4478,39,4517,15510,29.12,1,0,32,15,美濃區
352,2020-06-06 17:03:22,10856,296,35.86,11152,61,11213,23534,47.65,1,0,28,22,梓官區
353,2020-06-06 17:03:22,6173,193,38.78,6366,48,6414,15918,40.29,1,1,18,18,彌陀區
354,2020-06-06 17:03:22,9499,279,37.23,9778,51,9829,22764,43.18,1,0,21,19,茄萣區
355,2020-06-06 17:03:22,6592,283,21.4,6875,45,6920,18445,37.52,1,0,35,22,旗山區
356,2020-06-06 17:03:23,2400,146,22.01,2546,33,2579,9315,27.69,1,0,12,10,六龜區
357,2020-06-06 17:03:23,209,7,8.95,216,0,216,2334,9.25,1,1,4,4,那瑪夏區
358,2020-06-06 17:03:23,1107,52,21.19,1159,12,1171,4712,24.85,1,0,7,6,甲仙區
359,2020-06-06 17:03:23,179,24,5.36,203,2,205,2891,7.09,1,0,8,7,桃源區
360,2020-06-06 17:03:23,3863,145,30.86,4008,56,4064,12517,32.47,1,1,18,18,內門區
361,2020-06-06 17:03:23,60,1,3.95,61,0,61,1520,4.01,1,1,3,3,茂林區
362,2020-06-06 17:03:23,1989,93,19.43,2082,15,2097,7803,26.87,1,0,10,8,杉林區
363,2020-06-06 17:04:13,427983,12036,18.61,440019,2463,442482,1077168,41.08,38,5,1823,972,高雄市
364,2020-06-06 17:04:14,8634,213,40.93,8847,56,8903,19983,44.55,1,0,24,23,鹽埕區
365,2020-06-06 17:04:14,28589,744,18.87,29333,135,29468,71392,41.28,1,0,99,50,楠梓區
366,2020-06-06 17:04:14,16927,431,39.01,17358,91,17449,42092,41.45,1,0,42,41,新興區
367,2020-06-06 17:04:14,21191,620,13.4,21811,118,21929,67405,32.53,1,0,103,54,左營區
368,2020-06-06 17:04:14,20759,570,7.06,21329,112,21441,59854,35.82,1,0,228,51,鳳山區
369,2020-06-06 17:04:14,26850,681,18.81,27531,130,27661,66015,41.9,1,0,116,59,苓雅區
370,2020-06-06 17:04:14,32437,820,11.53,33257,167,33424,74773,44.7,1,0,189,61,三民區
371,2020-06-06 17:04:14,9437,252,39.81,9689,47,9736,23704,41.07,1,1,22,22,前金區
372,2020-06-06 17:04:14,26724,685,20.62,27409,130,27539,64808,42.49,1,0,89,48,小港區
373,2020-06-06 17:04:14,12964,335,11.43,13299,63,13362,34132,39.15,1,0,77,29,鼓山區
374,2020-06-06 17:04:14,30739,822,19.54,31561,167,31728,73802,42.99,1,0,119,63,前鎮區
375,2020-06-06 17:04:14,7065,186,29.49,7251,46,7297,15986,45.65,1,0,18,13,旗津區
376,2020-06-06 17:04:15,2475,91,38.52,2566,21,2587,6067,42.64,1,0,12,11,田寮區
377,2020-06-06 17:04:15,9499,279,37.23,9778,51,9829,22764,43.18,1,0,21,19,茄萣區
378,2020-06-06 17:04:15,15114,452,19.1,15566,69,15635,40036,39.05,1,0,72,38,岡山區
379,2020-06-06 17:04:15,10186,230,26.14,10416,46,10462,24191,43.25,1,0,28,18,鳥松區
380,2020-06-06 17:04:15,10017,280,34.21,10297,63,10360,21998,47.1,1,0,24,19,大社區
381,2020-06-06 17:04:15,13221,391,22.95,13612,99,13711,30880,44.4,1,0,51,30,林園區
382,2020-06-06 17:04:15,10903,286,30.52,11189,56,11245,25569,43.98,1,0,32,23,大樹區
383,2020-06-06 17:04:15,9305,258,39.03,9563,64,9627,21083,45.66,1,0,21,19,阿蓮區
384,2020-06-06 17:04:15,16315,515,38.45,16830,101,16931,38443,44.04,1,0,41,38,路竹區
385,2020-06-06 17:04:15,9263,251,36.53,9514,78,9592,22050,43.5,1,0,25,22,燕巢區
386,2020-06-06 17:04:15,8113,264,24.9,8377,46,8423,16108,52.29,1,0,31,17,橋頭區
387,2020-06-06 17:04:15,12885,352,17.42,13237,66,13303,28604,46.51,1,0,47,20,仁武區
388,2020-06-06 17:04:15,8941,230,9.41,9171,54,9225,23314,39.57,1,0,81,22,大寮區
389,2020-06-06 17:04:15,8293,287,33.04,8580,57,8637,19200,44.98,1,0,24,19,湖內區
390,2020-06-06 17:04:16,6592,283,21.4,6875,45,6920,18445,37.52,1,0,35,22,旗山區
391,2020-06-06 17:04:16,6173,193,38.78,6366,48,6414,15918,40.29,1,1,18,18,彌陀區
392,2020-06-06 17:04:16,3420,82,29.23,3502,19,3521,8416,41.84,1,0,12,10,永安區
393,2020-06-06 17:04:16,10856,296,35.86,11152,61,11213,23534,47.65,1,0,28,22,梓官區
394,2020-06-06 17:04:17,2400,146,22.01,2546,33,2579,9315,27.69,1,0,12,10,六龜區
395,2020-06-06 17:04:17,3863,145,30.86,4008,56,4064,12517,32.47,1,1,18,18,內門區
396,2020-06-06 17:04:17,1107,52,21.19,1159,12,1171,4712,24.85,1,0,7,6,甲仙區
397,2020-06-06 17:04:17,1989,93,19.43,2082,15,2097,7803,26.87,1,0,10,8,杉林區
398,2020-06-06 17:04:17,60,1,3.95,61,0,61,1520,4.01,1,1,3,3,茂林區
399,2020-06-06 17:04:17,179,24,5.36,203,2,205,2891,7.09,1,0,8,7,桃源區
400,2020-06-06 17:04:17,4289,189,12.57,4478,39,4517,15510,29.12,1,0,32,15,美濃區
401,2020-06-06 17:04:18,209,7,8.95,216,0,216,2334,9.25,1,1,4,4,那瑪夏區
402,2020-06-06 17:05:08,28589,744,18.87,29333,135,29468,71392,41.28,1,0,99,50,楠梓區
403,2020-06-06 17:05:08,26850,681,18.81,27531,130,27661,66015,41.9,1,0,116,59,苓雅區
404,2020-06-06 17:05:08,9437,252,39.81,9689,47,9736,23704,41.07,1,1,22,22,前金區
405,2020-06-06 17:05:08,21191,620,13.4,21811,118,21929,67405,32.53,1,0,103,54,左營區
406,2020-06-06 17:05:08,12964,335,11.43,13299,63,13362,34132,39.15,1,0,77,29,鼓山區
407,2020-06-06 17:05:08,7065,186,29.49,7251,46,7297,15986,45.65,1,0,18,13,旗津區
408,2020-06-06 17:05:08,32437,820,11.53,33257,167,33424,74773,44.7,1,0,189,61,三民區
409,2020-06-06 17:05:08,8634,213,40.93,8847,56,8903,19983,44.55,1,0,24,23,鹽埕區
410,2020-06-06 17:05:08,427983,12036,18.61,440019,2463,442482,1077168,41.08,38,5,1823,972,高雄市
411,2020-06-06 17:05:08,26724,685,20.62,27409,130,27539,64808,42.49,1,0,89,48,小港區
412,2020-06-06 17:05:08,16927,431,39.01,17358,91,17449,42092,41.45,1,0,42,41,新興區
413,2020-06-06 17:05:08,30739,822,19.54,31561,167,31728,73802,42.99,1,0,119,63,前鎮區
414,2020-06-06 17:05:09,9305,258,39.03,9563,64,9627,21083,45.66,1,0,21,19,阿蓮區
415,2020-06-06 17:05:09,9499,279,37.23,9778,51,9829,22764,43.18,1,0,21,19,茄萣區
416,2020-06-06 17:05:09,9263,251,36.53,9514,78,9592,22050,43.5,1,0,25,22,燕巢區
417,2020-06-06 17:05:09,8113,264,24.9,8377,46,8423,16108,52.29,1,0,31,17,橋頭區
418,2020-06-06 17:05:09,8941,230,9.41,9171,54,9225,23314,39.57,1,0,81,22,大寮區
419,2020-06-06 17:05:09,13221,391,22.95,13612,99,13711,30880,44.4,1,0,51,30,林園區
420,2020-06-06 17:05:09,12885,352,17.42,13237,66,13303,28604,46.51,1,0,47,20,仁武區
421,2020-06-06 17:05:09,8293,287,33.04,8580,57,8637,19200,44.98,1,0,24,19,湖內區
422,2020-06-06 17:05:09,3420,82,29.23,3502,19,3521,8416,41.84,1,0,12,10,永安區
423,2020-06-06 17:05:09,10186,230,26.14,10416,46,10462,24191,43.25,1,0,28,18,鳥松區
424,2020-06-06 17:05:09,2475,91,38.52,2566,21,2587,6067,42.64,1,0,12,11,田寮區
425,2020-06-06 17:05:09,20759,570,7.06,21329,112,21441,59854,35.82,1,0,228,51,鳳山區
426,2020-06-06 17:05:09,10017,280,34.21,10297,63,10360,21998,47.1,1,0,24,19,大社區
427,2020-06-06 17:05:09,10903,286,30.52,11189,56,11245,25569,43.98,1,0,32,23,大樹區
428,2020-06-06 17:05:09,15114,452,19.1,15566,69,15635,40036,39.05,1,0,72,38,岡山區
429,2020-06-06 17:05:09,16315,515,38.45,16830,101,16931,38443,44.04,1,0,41,38,路竹區
430,2020-06-06 17:05:10,4289,189,12.57,4478,39,4517,15510,29.12,1,0,32,15,美濃區
431,2020-06-06 17:05:10,1107,52,21.19,1159,12,1171,4712,24.85,1,0,7,6,甲仙區
432,2020-06-06 17:05:10,179,24,5.36,203,2,205,2891,7.09,1,0,8,7,桃源區
433,2020-06-06 17:05:10,209,7,8.95,216,0,216,2334,9.25,1,1,4,4,那瑪夏區
434,2020-06-06 17:05:10,6173,193,38.78,6366,48,6414,15918,40.29,1,1,18,18,彌陀區
435,2020-06-06 17:05:10,3863,145,30.86,4008,56,4064,12517,32.47,1,1,18,18,內門區
436,2020-06-06 17:05:10,1989,93,19.43,2082,15,2097,7803,26.87,1,0,10,8,杉林區
437,2020-06-06 17:05:10,60,1,3.95,61,0,61,1520,4.01,1,1,3,3,茂林區
438,2020-06-06 17:05:10,2400,146,22.01,2546,33,2579,9315,27.69,1,0,12,10,六龜區
439,2020-06-06 17:05:10,10856,296,35.86,11152,61,11213,23534,47.65,1,0,28,22,梓官區
440,2020-06-06 17:05:10,6592,283,21.4,6875,45,6920,18445,37.52,1,0,35,22,旗山區
441,2020-06-06 17:06:00,12964,335,11.43,13299,63,13362,34132,39.15,1,0,77,29,鼓山區
442,2020-06-06 17:06:00,8634,213,40.93,8847,56,8903,19983,44.55,1,0,24,23,鹽埕區
443,2020-06-06 17:06:00,21191,620,13.4,21811,118,21929,67405,32.53,1,0,103,54,左營區
444,2020-06-06 17:06:00,427983,12036,18.61,440019,2463,442482,1077168,41.08,38,5,1823,972,高雄市
445,2020-06-06 17:06:00,28589,744,18.87,29333,135,29468,71392,41.28,1,0,99,50,楠梓區
446,2020-06-06 17:06:01,13221,391,22.95,13612,99,13711,30880,44.4,1,0,51,30,林園區
447,2020-06-06 17:06:01,30739,822,19.54,31561,167,31728,73802,42.99,1,0,119,63,前鎮區
448,2020-06-06 17:06:01,7065,186,29.49,7251,46,7297,15986,45.65,1,0,18,13,旗津區
449,2020-06-06 17:06:01,8941,230,9.41,9171,54,9225,23314,39.57,1,0,81,22,大寮區
450,2020-06-06 17:06:01,16927,431,39.01,17358,91,17449,42092,41.45,1,0,42,41,新興區
451,2020-06-06 17:06:01,26850,681,18.81,27531,130,27661,66015,41.9,1,0,116,59,苓雅區
452,2020-06-06 17:06:01,26724,685,20.62,27409,130,27539,64808,42.49,1,0,89,48,小港區
453,2020-06-06 17:06:01,9437,252,39.81,9689,47,9736,23704,41.07,1,1,22,22,前金區
454,2020-06-06 17:06:01,32437,820,11.53,33257,167,33424,74773,44.7,1,0,189,61,三民區
455,2020-06-06 17:06:01,20759,570,7.06,21329,112,21441,59854,35.82,1,0,228,51,鳳山區
456,2020-06-06 17:06:02,10186,230,26.14,10416,46,10462,24191,43.25,1,0,28,18,鳥松區
457,2020-06-06 17:06:02,10017,280,34.21,10297,63,10360,21998,47.1,1,0,24,19,大社區
458,2020-06-06 17:06:02,10903,286,30.52,11189,56,11245,25569,43.98,1,0,32,23,大樹區
459,2020-06-06 17:06:02,12885,352,17.42,13237,66,13303,28604,46.51,1,0,47,20,仁武區
460,2020-06-06 17:06:03,9499,279,37.23,9778,51,9829,22764,43.18,1,0,21,19,茄萣區
461,2020-06-06 17:06:03,9263,251,36.53,9514,78,9592,22050,43.5,1,0,25,22,燕巢區
462,2020-06-06 17:06:03,15114,452,19.1,15566,69,15635,40036,39.05,1,0,72,38,岡山區
463,2020-06-06 17:06:03,6173,193,38.78,6366,48,6414,15918,40.29,1,1,18,18,彌陀區
464,2020-06-06 17:06:03,8293,287,33.04,8580,57,8637,19200,44.98,1,0,24,19,湖內區
465,2020-06-06 17:06:03,10856,296,35.86,11152,61,11213,23534,47.65,1,0,28,22,梓官區
466,2020-06-06 17:06:03,2475,91,38.52,2566,21,2587,6067,42.64,1,0,12,11,田寮區
467,2020-06-06 17:06:03,8113,264,24.9,8377,46,8423,16108,52.29,1,0,31,17,橋頭區
468,2020-06-06 17:06:03,3420,82,29.23,3502,19,3521,8416,41.84,1,0,12,10,永安區
469,2020-06-06 17:06:03,9305,258,39.03,9563,64,9627,21083,45.66,1,0,21,19,阿蓮區
470,2020-06-06 17:06:03,6592,283,21.4,6875,45,6920,18445,37.52,1,0,35,22,旗山區
471,2020-06-06 17:06:03,16315,515,38.45,16830,101,16931,38443,44.04,1,0,41,38,路竹區
472,2020-06-06 17:06:03,4289,189,12.57,4478,39,4517,15510,29.12,1,0,32,15,美濃區
473,2020-06-06 17:06:03,2400,146,22.01,2546,33,2579,9315,27.69,1,0,12,10,六龜區
474,2020-06-06 17:06:04,60,1,3.95,61,0,61,1520,4.01,1,1,3,3,茂林區
475,2020-06-06 17:06:04,1989,93,19.43,2082,15,2097,7803,26.87,1,0,10,8,杉林區
476,2020-06-06 17:06:04,1107,52,21.19,1159,12,1171,4712,24.85,1,0,7,6,甲仙區
477,2020-06-06 17:06:04,3863,145,30.86,4008,56,4064,12517,32.47,1,1,18,18,內門區
478,2020-06-06 17:06:05,209,7,8.95,216,0,216,2334,9.25,1,1,4,4,那瑪夏區
479,2020-06-06 17:06:05,179,24,5.36,203,2,205,2891,7.09,1,0,8,7,桃源區
480,2020-06-06 17:06:55,9437,252,39.81,9689,47,9736,23704,41.07,1,1,22,22,前金區
481,2020-06-06 17:06:55,38459,951,13.67,39410,209,39619,90932,43.57,1,0,189,70,三民區
482,2020-06-06 17:06:55,491697,13757,21.38,505454,2874,508328,1232532,41.24,38,8,1823,1086,高雄市
483,2020-06-06 17:06:55,7800,210,32.56,8010,50,8060,17456,46.17,1,0,18,14,旗津區
484,2020-06-06 17:06:55,32714,848,21.59,33562,156,33718,80986,41.63,1,0,99,56,楠梓區
485,2020-06-06 17:06:55,15423,381,13.6,15804,81,15885,39846,39.87,1,0,77,33,鼓山區
486,2020-06-06 17:06:55,16927,431,39.01,17358,91,17449,42092,41.45,1,0,42,41,新興區
487,2020-06-06 17:06:55,31629,822,24.41,32451,155,32606,76464,42.64,1,0,89,56,小港區
488,2020-06-06 17:06:55,24451,694,15.46,25145,129,25274,76099,33.21,1,0,103,59,左營區
489,2020-06-06 17:06:55,24164,678,8.22,24842,135,24977,68424,36.5,1,0,228,58,鳳山區
490,2020-06-06 17:06:55,31753,824,22.25,32577,154,32731,78925,41.47,1,0,116,69,苓雅區
491,2020-06-06 17:06:55,38807,1029,24.67,39836,213,40049,92747,43.18,1,0,119,76,前鎮區
492,2020-06-06 17:06:55,9107,221,43.17,9328,57,9385,21094,44.49,1,1,24,24,鹽埕區
493,2020-06-06 17:06:56,9499,279,37.23,9778,51,9829,22764,43.18,1,0,21,19,茄萣區
494,2020-06-06 17:06:56,9263,251,36.53,9514,78,9592,22050,43.5,1,0,25,22,燕巢區
495,2020-06-06 17:06:56,8779,299,34.98,9078,60,9138,20128,45.4,1,0,24,20,湖內區
496,2020-06-06 17:06:56,18461,543,23.33,19004,96,19100,48162,39.66,1,0,72,45,岡山區
497,2020-06-06 17:06:56,11762,303,32.93,12065,65,12130,27653,43.87,1,0,32,25,大樹區
498,2020-06-06 17:06:56,10530,297,35.96,10827,67,10894,23245,46.87,1,0,24,20,大社區
499,2020-06-06 17:06:56,2475,91,38.52,2566,21,2587,6067,42.64,1,0,12,11,田寮區
500,2020-06-06 17:06:56,11523,285,12.13,11808,70,11878,29475,40.3,1,0,81,27,大寮區
501,2020-06-06 17:06:56,10711,339,32.88,11050,57,11107,21043,52.78,1,0,31,21,橋頭區
502,2020-06-06 17:06:56,4202,104,35.92,4306,21,4327,10008,43.24,1,0,12,11,永安區
503,2020-06-06 17:06:56,11464,270,29.42,11734,57,11791,27322,43.16,1,0,28,20,鳥松區
504,2020-06-06 17:06:56,16441,473,28.53,16914,133,17047,38321,44.48,1,0,51,36,林園區
505,2020-06-06 17:06:56,9305,258,39.03,9563,64,9627,21083,45.66,1,0,21,19,阿蓮區
506,2020-06-06 17:06:56,16900,538,39.83,17438,108,17546,39643,44.26,1,0,41,39,路竹區
507,2020-06-06 17:06:56,17011,460,23.0,17471,93,17564,38144,46.05,1,0,47,26,仁武區
508,2020-06-06 17:06:57,2733,121,26.69,2854,28,2882,10238,28.15,1,1,10,10,杉林區
509,2020-06-06 17:06:57,2400,146,22.01,2546,33,2579,9315,27.69,1,0,12,10,六龜區
510,2020-06-06 17:06:57,5477,245,16.06,5722,50,5772,19301,29.91,1,0,32,18,美濃區
511,2020-06-06 17:06:57,1223,56,23.41,1279,16,1295,5224,24.79,1,1,7,7,甲仙區
512,2020-06-06 17:06:57,179,24,5.36,203,2,205,2891,7.09,1,0,8,7,桃源區
513,2020-06-06 17:06:57,8131,344,26.39,8475,54,8529,22837,37.35,1,0,35,27,旗山區
514,2020-06-06 17:06:57,3863,145,30.86,4008,56,4064,12517,32.47,1,1,18,18,內門區
515,2020-06-06 17:06:57,6173,193,38.78,6366,48,6414,15918,40.29,1,1,18,18,彌陀區
516,2020-06-06 17:06:57,12252,344,40.47,12596,69,12665,26560,47.68,1,0,28,25,梓官區
517,2020-06-06 17:06:57,209,7,8.95,216,0,216,2334,9.25,1,1,4,4,那瑪夏區
518,2020-06-06 17:06:57,60,1,3.95,61,0,61,1520,4.01,1,1,3,3,茂林區
519,2020-06-06 17:07:48,9437,252,39.81,9689,47,9736,23704,41.07,1,1,22,22,前金區
520,2020-06-06 17:07:48,31753,824,22.25,32577,154,32731,78925,41.47,1,0,116,69,苓雅區
521,2020-06-06 17:07:48,16927,431,39.01,17358,91,17449,42092,41.45,1,0,42,41,新興區
522,2020-06-06 17:07:48,24451,694,15.46,25145,129,25274,76099,33.21,1,0,103,59,左營區
523,2020-06-06 17:07:48,9107,221,43.17,9328,57,9385,21094,44.49,1,1,24,24,鹽埕區
524,2020-06-06 17:07:48,32714,848,21.59,33562,156,33718,80986,41.63,1,0,99,56,楠梓區
525,2020-06-06 17:07:48,491697,13757,21.38,505454,2874,508328,1232532,41.24,38,8,1823,1086,高雄市
526,2020-06-06 17:07:48,15423,381,13.6,15804,81,15885,39846,39.87,1,0,77,33,鼓山區
527,2020-06-06 17:07:48,38459,951,13.67,39410,209,39619,90932,43.57,1,0,189,70,三民區
528,2020-06-06 17:07:49,11523,285,12.13,11808,70,11878,29475,40.3,1,0,81,27,大寮區
529,2020-06-06 17:07:49,16441,473,28.53,16914,133,17047,38321,44.48,1,0,51,36,林園區
530,2020-06-06 17:07:49,7800,210,32.56,8010,50,8060,17456,46.17,1,0,18,14,旗津區
531,2020-06-06 17:07:49,38807,1029,24.67,39836,213,40049,92747,43.18,1,0,119,76,前鎮區
532,2020-06-06 17:07:49,24164,678,8.22,24842,135,24977,68424,36.5,1,0,228,58,鳳山區
533,2020-06-06 17:07:49,11762,303,32.93,12065,65,12130,27653,43.87,1,0,32,25,大樹區
534,2020-06-06 17:07:49,31629,822,24.41,32451,155,32606,76464,42.64,1,0,89,56,小港區
535,2020-06-06 17:07:50,17011,460,23.0,17471,93,17564,38144,46.05,1,0,47,26,仁武區
536,2020-06-06 17:07:50,10711,339,32.88,11050,57,11107,21043,52.78,1,0,31,21,橋頭區
537,2020-06-06 17:07:50,18461,543,23.33,19004,96,19100,48162,39.66,1,0,72,45,岡山區
538,2020-06-06 17:07:50,9263,251,36.53,9514,78,9592,22050,43.5,1,0,25,22,燕巢區
539,2020-06-06 17:07:50,9305,258,39.03,9563,64,9627,21083,45.66,1,0,21,19,阿蓮區
540,2020-06-06 17:07:50,2475,91,38.52,2566,21,2587,6067,42.64,1,0,12,11,田寮區
541,2020-06-06 17:07:50,11464,270,29.42,11734,57,11791,27322,43.16,1,0,28,20,鳥松區
542,2020-06-06 17:07:50,10530,297,35.96,10827,67,10894,23245,46.87,1,0,24,20,大社區
543,2020-06-06 17:07:51,8779,299,34.98,9078,60,9138,20128,45.4,1,0,24,20,湖內區
544,2020-06-06 17:07:51,16900,538,39.83,17438,108,17546,39643,44.26,1,0,41,39,路竹區
545,2020-06-06 17:07:51,9499,279,37.23,9778,51,9829,22764,43.18,1,0,21,19,茄萣區
546,2020-06-06 17:07:52,5477,245,16.06,5722,50,5772,19301,29.91,1,0,32,18,美濃區
547,2020-06-06 17:07:52,6173,193,38.78,6366,48,6414,15918,40.29,1,1,18,18,彌陀區
548,2020-06-06 17:07:52,8131,344,26.39,8475,54,8529,22837,37.35,1,0,35,27,旗山區
549,2020-06-06 17:07:52,3863,145,30.86,4008,56,4064,12517,32.47,1,1,18,18,內門區
550,2020-06-06 17:07:52,12252,344,40.47,12596,69,12665,26560,47.68,1,0,28,25,梓官區
551,2020-06-06 17:07:52,2400,146,22.01,2546,33,2579,9315,27.69,1,0,12,10,六龜區
552,2020-06-06 17:07:52,4202,104,35.92,4306,21,4327,10008,43.24,1,0,12,11,永安區
553,2020-06-06 17:07:52,2733,121,26.69,2854,28,2882,10238,28.15,1,1,10,10,杉林區
554,2020-06-06 17:07:52,1223,56,23.41,1279,16,1295,5224,24.79,1,1,7,7,甲仙區
555,2020-06-06 17:07:53,179,24,5.36,203,2,205,2891,7.09,1,0,8,7,桃源區
556,2020-06-06 17:07:53,209,7,8.95,216,0,216,2334,9.25,1,1,4,4,那瑪夏區
557,2020-06-06 17:07:53,60,1,3.95,61,0,61,1520,4.01,1,1,3,3,茂林區
558,2020-06-06 17:08:43,24451,694,15.46,25145,129,25274,76099,33.21,1,0,103,59,左營區
559,2020-06-06 17:08:43,15423,381,13.6,15804,81,15885,39846,39.87,1,0,77,33,鼓山區
560,2020-06-06 17:08:43,9107,221,43.17,9328,57,9385,21094,44.49,1,1,24,24,鹽埕區
561,2020-06-06 17:08:43,16927,431,39.01,17358,91,17449,42092,41.45,1,0,42,41,新興區
562,2020-06-06 17:08:43,32714,848,21.59,33562,156,33718,80986,41.63,1,0,99,56,楠梓區
563,2020-06-06 17:08:43,9437,252,39.81,9689,47,9736,23704,41.07,1,1,22,22,前金區
564,2020-06-06 17:08:43,491697,13757,21.38,505454,2874,508328,1232532,41.24,38,8,1823,1086,高雄市
565,2020-06-06 17:08:43,38807,1029,24.67,39836,213,40049,92747,43.18,1,0,119,76,前鎮區
566,2020-06-06 17:08:43,31753,824,22.25,32577,154,32731,78925,41.47,1,0,116,69,苓雅區
567,2020-06-06 17:08:43,38459,951,13.67,39410,209,39619,90932,43.57,1,0,189,70,三民區
568,2020-06-06 17:08:44,11523,285,12.13,11808,70,11878,29475,40.3,1,0,81,27,大寮區
569,2020-06-06 17:08:44,31629,822,24.41,32451,155,32606,76464,42.64,1,0,89,56,小港區
570,2020-06-06 17:08:44,24164,678,8.22,24842,135,24977,68424,36.5,1,0,228,58,鳳山區
571,2020-06-06 17:08:44,10530,297,35.96,10827,67,10894,23245,46.87,1,0,24,20,大社區
572,2020-06-06 17:08:44,16441,473,28.53,16914,133,17047,38321,44.48,1,0,51,36,林園區
573,2020-06-06 17:08:44,11762,303,32.93,12065,65,12130,27653,43.87,1,0,32,25,大樹區
574,2020-06-06 17:08:44,7800,210,32.56,8010,50,8060,17456,46.17,1,0,18,14,旗津區
575,2020-06-06 17:08:45,10711,339,32.88,11050,57,11107,21043,52.78,1,0,31,21,橋頭區
576,2020-06-06 17:08:45,18461,543,23.33,19004,96,19100,48162,39.66,1,0,72,45,岡山區
577,2020-06-06 17:08:45,11464,270,29.42,11734,57,11791,27322,43.16,1,0,28,20,鳥松區
578,2020-06-06 17:08:45,17011,460,23.0,17471,93,17564,38144,46.05,1,0,47,26,仁武區
579,2020-06-06 17:08:46,4202,104,35.92,4306,21,4327,10008,43.24,1,0,12,11,永安區
580,2020-06-06 17:08:46,6173,193,38.78,6366,48,6414,15918,40.29,1,1,18,18,彌陀區
581,2020-06-06 17:08:46,8779,299,34.98,9078,60,9138,20128,45.4,1,0,24,20,湖內區
582,2020-06-06 17:08:46,9305,258,39.03,9563,64,9627,21083,45.66,1,0,21,19,阿蓮區
583,2020-06-06 17:08:46,9263,251,36.53,9514,78,9592,22050,43.5,1,0,25,22,燕巢區
584,2020-06-06 17:08:46,12252,344,40.47,12596,69,12665,26560,47.68,1,0,28,25,梓官區
585,2020-06-06 17:08:46,9499,279,37.23,9778,51,9829,22764,43.18,1,0,21,19,茄萣區
586,2020-06-06 17:08:46,2475,91,38.52,2566,21,2587,6067,42.64,1,0,12,11,田寮區
587,2020-06-06 17:08:46,16900,538,39.83,17438,108,17546,39643,44.26,1,0,41,39,路竹區
588,2020-06-06 17:08:47,8131,344,26.39,8475,54,8529,22837,37.35,1,0,35,27,旗山區
589,2020-06-06 17:08:47,60,1,3.95,61,0,61,1520,4.01,1,1,3,3,茂林區
590,2020-06-06 17:08:47,209,7,8.95,216,0,216,2334,9.25,1,1,4,4,那瑪夏區
591,2020-06-06 17:08:47,2733,121,26.69,2854,28,2882,10238,28.15,1,1,10,10,杉林區
592,2020-06-06 17:08:47,2400,146,22.01,2546,33,2579,9315,27.69,1,0,12,10,六龜區
593,2020-06-06 17:08:47,3863,145,30.86,4008,56,4064,12517,32.47,1,1,18,18,內門區
594,2020-06-06 17:08:47,179,24,5.36,203,2,205,2891,7.09,1,0,8,7,桃源區
595,2020-06-06 17:08:47,5477,245,16.06,5722,50,5772,19301,29.91,1,0,32,18,美濃區
596,2020-06-06 17:08:47,1223,56,23.41,1279,16,1295,5224,24.79,1,1,7,7,甲仙區
597,2020-06-06 17:09:38,9437,252,39.81,9689,47,9736,23704,41.07,1,1,22,22,前金區
598,2020-06-06 17:09:38,17452,443,40.21,17895,96,17991,43397,41.46,1,1,42,42,新興區
599,2020-06-06 17:09:38,19171,545,33.27,19716,151,19867,44531,44.61,1,0,51,41,林園區
600,2020-06-06 17:09:38,8334,228,34.79,8562,52,8614,18677,46.12,1,0,18,15,旗津區
601,2020-06-06 17:09:38,543739,15179,23.64,558918,3123,562041,1360171,41.32,38,10,1823,1177,高雄市
602,2020-06-06 17:09:38,13079,313,13.77,13392,77,13469,33150,40.63,1,0,81,30,大寮區
603,2020-06-06 17:09:38,16713,411,14.74,17124,84,17208,42906,40.11,1,0,77,35,鼓山區
604,2020-06-06 17:09:38,9107,221,43.17,9328,57,9385,21094,44.49,1,1,24,24,鹽埕區
605,2020-06-06 17:09:38,35183,904,24.65,36087,169,36256,87802,41.29,1,0,116,76,苓雅區
606,2020-06-06 17:09:38,35227,922,23.25,36149,164,36313,87805,41.36,1,0,99,60,楠梓區
607,2020-06-06 17:09:38,30217,826,19.11,31043,149,31192,90301,34.54,1,0,103,67,左營區
608,2020-06-06 17:09:38,33599,873,25.93,34472,162,34634,81138,42.69,1,0,89,59,小港區
609,2020-06-06 17:09:38,41971,1133,26.68,43104,225,43329,101088,42.86,1,0,119,81,前鎮區
610,2020-06-06 17:09:38,45032,1118,16.01,46150,231,46381,105990,43.76,1,0,189,81,三民區
611,2020-06-06 17:09:38,30357,841,10.32,31198,164,31362,84359,37.18,1,0,228,70,鳳山區
612,2020-06-06 17:09:39,11371,361,34.9,11732,60,11792,22357,52.74,1,0,31,22,橋頭區
613,2020-06-06 17:09:39,9951,273,41.74,10224,67,10291,22623,45.49,1,0,21,20,阿蓮區
614,2020-06-06 17:09:39,10272,285,40.51,10557,87,10644,24326,43.76,1,0,25,24,燕巢區
615,2020-06-06 17:09:39,20420,595,25.81,21015,103,21118,52768,40.02,1,0,72,49,岡山區
616,2020-06-06 17:09:39,9268,314,36.93,9582,62,9644,21211,45.47,1,0,24,21,湖內區
617,2020-06-06 17:09:39,12377,317,34.65,12694,67,12761,29359,43.47,1,0,32,26,大樹區
618,2020-06-06 17:09:39,13027,310,33.43,13337,69,13406,31196,42.97,1,0,28,22,鳥松區
619,2020-06-06 17:09:39,2475,91,38.52,2566,21,2587,6067,42.64,1,0,12,11,田寮區
620,2020-06-06 17:09:39,11210,319,38.28,11529,72,11601,24605,47.15,1,0,24,21,大社區
621,2020-06-06 17:09:39,19883,532,26.88,20415,106,20521,44578,46.03,1,0,47,30,仁武區
622,2020-06-06 17:09:39,17618,556,41.52,18174,110,18284,41372,44.19,1,0,41,40,路竹區
623,2020-06-06 17:09:40,2644,151,24.25,2795,35,2830,10198,27.75,1,0,12,11,六龜區
624,2020-06-06 17:09:40,6173,193,38.78,6366,48,6414,15918,40.29,1,1,18,18,彌陀區
625,2020-06-06 17:09:40,7147,318,20.95,7465,64,7529,24888,30.25,1,0,32,23,美濃區
626,2020-06-06 17:09:40,8956,386,29.07,9342,62,9404,24534,38.33,1,0,35,29,旗山區
627,2020-06-06 17:09:40,12999,375,42.94,13374,80,13454,27982,48.08,1,0,28,26,梓官區
628,2020-06-06 17:09:40,4202,104,35.92,4306,21,4327,10008,43.24,1,0,12,11,永安區
629,2020-06-06 17:09:40,10600,315,41.54,10915,59,10974,25515,43.01,1,1,21,21,茄萣區
630,2020-06-06 17:09:41,3863,145,30.86,4008,56,4064,12517,32.47,1,1,18,18,內門區
631,2020-06-06 17:09:41,209,7,8.95,216,0,216,2334,9.25,1,1,4,4,那瑪夏區
632,2020-06-06 17:09:41,179,24,5.36,203,2,205,2891,7.09,1,0,8,7,桃源區
633,2020-06-06 17:09:41,60,1,3.95,61,0,61,1520,4.01,1,1,3,3,茂林區
634,2020-06-06 17:09:41,2733,121,26.69,2854,28,2882,10238,28.15,1,1,10,10,杉林區
635,2020-06-06 17:09:41,1223,56,23.41,1279,16,1295,5224,24.79,1,1,7,7,甲仙區
636,2020-06-06 17:10:31,9107,221,43.17,9328,57,9385,21094,44.49,1,1,24,24,鹽埕區
637,2020-06-06 17:10:31,30217,826,19.11,31043,149,31192,90301,34.54,1,0,103,67,左營區
638,2020-06-06 17:10:31,543739,15179,23.64,558918,3123,562041,1360171,41.32,38,10,1823,1177,高雄市
639,2020-06-06 17:10:31,16713,411,14.74,17124,84,17208,42906,40.11,1,0,77,35,鼓山區
640,2020-06-06 17:10:32,9437,252,39.81,9689,47,9736,23704,41.07,1,1,22,22,前金區
641,2020-06-06 17:10:32,35227,922,23.25,36149,164,36313,87805,41.36,1,0,99,60,楠梓區
642,2020-06-06 17:10:32,17452,443,40.21,17895,96,17991,43397,41.46,1,1,42,42,新興區
643,2020-06-06 17:10:32,45032,1118,16.01,46150,231,46381,105990,43.76,1,0,189,81,三民區
644,2020-06-06 17:10:33,33599,873,25.93,34472,162,34634,81138,42.69,1,0,89,59,小港區
645,2020-06-06 17:10:33,8334,228,34.79,8562,52,8614,18677,46.12,1,0,18,15,旗津區
646,2020-06-06 17:10:33,30357,841,10.32,31198,164,31362,84359,37.18,1,0,228,70,鳳山區
647,2020-06-06 17:10:33,41971,1133,26.68,43104,225,43329,101088,42.86,1,0,119,81,前鎮區
648,2020-06-06 17:10:33,35183,904,24.65,36087,169,36256,87802,41.29,1,0,116,76,苓雅區
649,2020-06-06 17:10:34,13079,313,13.77,13392,77,13469,33150,40.63,1,0,81,30,大寮區
650,2020-06-06 17:10:34,19883,532,26.88,20415,106,20521,44578,46.03,1,0,47,30,仁武區
651,2020-06-06 17:10:34,11210,319,38.28,11529,72,11601,24605,47.15,1,0,24,21,大社區
652,2020-06-06 17:10:34,12377,317,34.65,12694,67,12761,29359,43.47,1,0,32,26,大樹區
653,2020-06-06 17:10:34,13027,310,33.43,13337,69,13406,31196,42.97,1,0,28,22,鳥松區
654,2020-06-06 17:10:34,19171,545,33.27,19716,151,19867,44531,44.61,1,0,51,41,林園區
655,2020-06-06 17:10:35,17618,556,41.52,18174,110,18284,41372,44.19,1,0,41,40,路竹區
656,2020-06-06 17:10:35,2475,91,38.52,2566,21,2587,6067,42.64,1,0,12,11,田寮區
657,2020-06-06 17:10:35,11371,361,34.9,11732,60,11792,22357,52.74,1,0,31,22,橋頭區
658,2020-06-06 17:10:35,20420,595,25.81,21015,103,21118,52768,40.02,1,0,72,49,岡山區
659,2020-06-06 17:10:35,10600,315,41.54,10915,59,10974,25515,43.01,1,1,21,21,茄萣區
660,2020-06-06 17:10:35,6173,193,38.78,6366,48,6414,15918,40.29,1,1,18,18,彌陀區
661,2020-06-06 17:10:35,9951,273,41.74,10224,67,10291,22623,45.49,1,0,21,20,阿蓮區
662,2020-06-06 17:10:35,4202,104,35.92,4306,21,4327,10008,43.24,1,0,12,11,永安區
663,2020-06-06 17:10:35,10272,285,40.51,10557,87,10644,24326,43.76,1,0,25,24,燕巢區
664,2020-06-06 17:10:35,9268,314,36.93,9582,62,9644,21211,45.47,1,0,24,21,湖內區
665,2020-06-06 17:10:36,209,7,8.95,216,0,216,2334,9.25,1,1,4,4,那瑪夏區
666,2020-06-06 17:10:36,179,24,5.36,203,2,205,2891,7.09,1,0,8,7,桃源區
667,2020-06-06 17:10:36,2733,121,26.69,2854,28,2882,10238,28.15,1,1,10,10,杉林區
668,2020-06-06 17:10:36,7147,318,20.95,7465,64,7529,24888,30.25,1,0,32,23,美濃區
669,2020-06-06 17:10:36,8956,386,29.07,9342,62,9404,24534,38.33,1,0,35,29,旗山區
670,2020-06-06 17:10:36,3863,145,30.86,4008,56,4064,12517,32.47,1,1,18,18,內門區
671,2020-06-06 17:10:36,2644,151,24.25,2795,35,2830,10198,27.75,1,0,12,11,六龜區
672,2020-06-06 17:10:36,1223,56,23.41,1279,16,1295,5224,24.79,1,1,7,7,甲仙區
673,2020-06-06 17:10:36,12999,375,42.94,13374,80,13454,27982,48.08,1,0,28,26,梓官區
674,2020-06-06 17:10:36,60,1,3.95,61,0,61,1520,4.01,1,1,3,3,茂林區
675,2020-06-06 17:11:26,16713,411,14.74,17124,84,17208,42906,40.11,1,0,77,35,鼓山區
676,2020-06-06 17:11:26,543739,15179,23.64,558918,3123,562041,1360171,41.32,38,10,1823,1177,高雄市
677,2020-06-06 17:11:26,9107,221,43.17,9328,57,9385,21094,44.49,1,1,24,24,鹽埕區
678,2020-06-06 17:11:27,33599,873,25.93,34472,162,34634,81138,42.69,1,0,89,59,小港區
679,2020-06-06 17:11:27,35183,904,24.65,36087,169,36256,87802,41.29,1,0,116,76,苓雅區
680,2020-06-06 17:11:27,9437,252,39.81,9689,47,9736,23704,41.07,1,1,22,22,前金區
681,2020-06-06 17:11:27,45032,1118,16.01,46150,231,46381,105990,43.76,1,0,189,81,三民區
682,2020-06-06 17:11:27,17452,443,40.21,17895,96,17991,43397,41.46,1,1,42,42,新興區
683,2020-06-06 17:11:27,30217,826,19.11,31043,149,31192,90301,34.54,1,0,103,67,左營區
684,2020-06-06 17:11:27,41971,1133,26.68,43104,225,43329,101088,42.86,1,0,119,81,前鎮區
685,2020-06-06 17:11:27,8334,228,34.79,8562,52,8614,18677,46.12,1,0,18,15,旗津區
686,2020-06-06 17:11:27,35227,922,23.25,36149,164,36313,87805,41.36,1,0,99,60,楠梓區
687,2020-06-06 17:11:28,2475,91,38.52,2566,21,2587,6067,42.64,1,0,12,11,田寮區
688,2020-06-06 17:11:28,13027,310,33.43,13337,69,13406,31196,42.97,1,0,28,22,鳥松區
689,2020-06-06 17:11:28,11210,319,38.28,11529,72,11601,24605,47.15,1,0,24,21,大社區
690,2020-06-06 17:11:28,19883,532,26.88,20415,106,20521,44578,46.03,1,0,47,30,仁武區
691,2020-06-06 17:11:28,12377,317,34.65,12694,67,12761,29359,43.47,1,0,32,26,大樹區
692,2020-06-06 17:11:28,11371,361,34.9,11732,60,11792,22357,52.74,1,0,31,22,橋頭區
693,2020-06-06 17:11:28,20420,595,25.81,21015,103,21118,52768,40.02,1,0,72,49,岡山區
694,2020-06-06 17:11:28,13079,313,13.77,13392,77,13469,33150,40.63,1,0,81,30,大寮區
695,2020-06-06 17:11:28,30357,841,10.32,31198,164,31362,84359,37.18,1,0,228,70,鳳山區
696,2020-06-06 17:11:28,10272,285,40.51,10557,87,10644,24326,43.76,1,0,25,24,燕巢區
697,2020-06-06 17:11:28,9951,273,41.74,10224,67,10291,22623,45.49,1,0,21,20,阿蓮區
698,2020-06-06 17:11:28,19171,545,33.27,19716,151,19867,44531,44.61,1,0,51,41,林園區
699,2020-06-06 17:11:29,4202,104,35.92,4306,21,4327,10008,43.24,1,0,12,11,永安區
700,2020-06-06 17:11:29,7147,318,20.95,7465,64,7529,24888,30.25,1,0,32,23,美濃區
701,2020-06-06 17:11:29,2644,151,24.25,2795,35,2830,10198,27.75,1,0,12,11,六龜區
702,2020-06-06 17:11:29,10600,315,41.54,10915,59,10974,25515,43.01,1,1,21,21,茄萣區
703,2020-06-06 17:11:29,2733,121,26.69,2854,28,2882,10238,28.15,1,1,10,10,杉林區
704,2020-06-06 17:11:29,9268,314,36.93,9582,62,9644,21211,45.47,1,0,24,21,湖內區
705,2020-06-06 17:11:29,6173,193,38.78,6366,48,6414,15918,40.29,1,1,18,18,彌陀區
706,2020-06-06 17:11:29,8956,386,29.07,9342,62,9404,24534,38.33,1,0,35,29,旗山區
707,2020-06-06 17:11:29,1223,56,23.41,1279,16,1295,5224,24.79,1,1,7,7,甲仙區
708,2020-06-06 17:11:29,12999,375,42.94,13374,80,13454,27982,48.08,1,0,28,26,梓官區
709,2020-06-06 17:11:29,17618,556,41.52,18174,110,18284,41372,44.19,1,0,41,40,路竹區
710,2020-06-06 17:11:30,209,7,8.95,216,0,216,2334,9.25,1,1,4,4,那瑪夏區
711,2020-06-06 17:11:30,179,24,5.36,203,2,205,2891,7.09,1,0,8,7,桃源區
712,2020-06-06 17:11:30,3863,145,30.86,4008,56,4064,12517,32.47,1,1,18,18,內門區
713,2020-06-06 17:11:30,60,1,3.95,61,0,61,1520,4.01,1,1,3,3,茂林區
714,2020-06-06 17:12:20,18912,469,16.67,19381,92,19473,48222,40.38,1,0,77,39,鼓山區
715,2020-06-06 17:12:20,9107,221,43.17,9328,57,9385,21094,44.49,1,1,24,24,鹽埕區
716,2020-06-06 17:12:20,601412,16709,26.15,618121,3426,621547,1498536,41.48,38,14,1823,1281,高雄市
717,2020-06-06 17:12:21,37767,981,24.92,38748,171,38919,94527,41.17,1,0,99,64,楠梓區
718,2020-06-06 17:12:21,49848,1229,17.72,51077,254,51331,116985,43.88,1,0,189,89,三民區
719,2020-06-06 17:12:21,34695,932,21.94,35627,163,35790,101510,35.26,1,0,103,73,左營區
720,2020-06-06 17:12:21,17452,443,40.21,17895,96,17991,43397,41.46,1,1,42,42,新興區
721,2020-06-06 17:12:22,41207,1055,28.87,42262,207,42469,103476,41.04,1,0,116,87,苓雅區
722,2020-06-06 17:12:22,9437,252,39.81,9689,47,9736,23704,41.07,1,1,22,22,前金區
723,2020-06-06 17:12:23,22238,614,38.6,22852,176,23028,51076,45.09,1,0,51,46,林園區
724,2020-06-06 17:12:23,15884,378,16.72,16262,99,16361,39328,41.6,1,0,81,35,大寮區
725,2020-06-06 17:12:23,8334,228,34.79,8562,52,8614,18677,46.12,1,0,18,15,旗津區
726,2020-06-06 17:12:23,46842,1259,29.78,48101,246,48347,112789,42.86,1,0,119,89,前鎮區
727,2020-06-06 17:12:23,40343,1049,31.13,41392,190,41582,96691,43.01,1,0,89,69,小港區
728,2020-06-06 17:12:23,37810,1041,12.86,38851,196,39047,102658,38.04,1,0,228,85,鳳山區
729,2020-06-06 17:12:24,13406,341,37.53,13747,74,13821,31386,44.04,1,0,32,28,大樹區
730,2020-06-06 17:12:24,11733,332,40.07,12065,78,12143,25677,47.29,1,0,24,22,大社區
731,2020-06-06 17:12:25,21200,575,28.66,21775,115,21890,47522,46.06,1,0,47,32,仁武區
732,2020-06-06 17:12:25,14623,365,37.53,14988,82,15070,34525,43.65,1,0,28,25,鳥松區
733,2020-06-06 17:12:25,21935,642,27.73,22577,110,22687,55991,40.52,1,0,72,52,岡山區
734,2020-06-06 17:12:25,12608,397,38.7,13005,68,13073,24896,52.51,1,0,31,24,橋頭區
735,2020-06-06 17:12:26,6173,193,38.78,6366,48,6414,15918,40.29,1,1,18,18,彌陀區
736,2020-06-06 17:12:26,9770,333,38.93,10103,64,10167,22380,45.43,1,0,24,22,湖內區
737,2020-06-06 17:12:26,13365,385,44.15,13750,81,13831,28805,48.02,1,0,28,27,梓官區
738,2020-06-06 17:12:26,10600,315,41.54,10915,59,10974,25515,43.01,1,1,21,21,茄萣區
739,2020-06-06 17:12:26,18054,568,42.55,18622,111,18733,42432,44.15,1,1,41,41,路竹區
740,2020-06-06 17:12:26,4202,104,35.92,4306,21,4327,10008,43.24,1,0,12,11,永安區
741,2020-06-06 17:12:26,10559,281,44.29,10840,70,10910,23841,45.76,1,1,21,21,阿蓮區
742,2020-06-06 17:12:26,10618,306,41.88,10924,91,11015,25354,43.44,1,1,25,25,燕巢區
743,2020-06-06 17:12:26,10645,446,34.55,11091,74,11165,28738,38.85,1,0,35,33,旗山區
744,2020-06-06 17:12:26,2552,92,39.72,2644,21,2665,6425,41.48,1,1,12,12,田寮區
745,2020-06-06 17:12:26,2644,151,24.25,2795,35,2830,10198,27.75,1,0,12,11,六龜區
746,2020-06-06 17:12:26,8582,378,25.16,8960,76,9036,30067,30.05,1,0,32,28,美濃區
747,2020-06-06 17:12:27,2733,121,26.69,2854,28,2882,10238,28.15,1,1,10,10,杉林區
748,2020-06-06 17:12:27,1223,56,23.41,1279,16,1295,5224,24.79,1,1,7,7,甲仙區
749,2020-06-06 17:12:27,179,24,5.36,203,2,205,2891,7.09,1,0,8,7,桃源區
750,2020-06-06 17:12:27,60,1,3.95,61,0,61,1520,4.01,1,1,3,3,茂林區
751,2020-06-06 17:12:27,3863,145,30.86,4008,56,4064,12517,32.47,1,1,18,18,內門區
752,2020-06-06 17:12:28,209,7,8.95,216,0,216,2334,9.25,1,1,4,4,那瑪夏區
753,2020-06-06 17:13:18,601412,16709,26.15,618121,3426,621547,1498536,41.48,38,14,1823,1281,高雄市
754,2020-06-06 17:13:18,34695,932,21.94,35627,163,35790,101510,35.26,1,0,103,73,左營區
755,2020-06-06 17:13:18,9107,221,43.17,9328,57,9385,21094,44.49,1,1,24,24,鹽埕區
756,2020-06-06 17:13:18,18912,469,16.67,19381,92,19473,48222,40.38,1,0,77,39,鼓山區
757,2020-06-06 17:13:19,17452,443,40.21,17895,96,17991,43397,41.46,1,1,42,42,新興區
758,2020-06-06 17:13:19,9437,252,39.81,9689,47,9736,23704,41.07,1,1,22,22,前金區
759,2020-06-06 17:13:19,41207,1055,28.87,42262,207,42469,103476,41.04,1,0,116,87,苓雅區
760,2020-06-06 17:13:19,49848,1229,17.72,51077,254,51331,116985,43.88,1,0,189,89,三民區
761,2020-06-06 17:13:19,8334,228,34.79,8562,52,8614,18677,46.12,1,0,18,15,旗津區
762,2020-06-06 17:13:19,37767,981,24.92,38748,171,38919,94527,41.17,1,0,99,64,楠梓區
763,2020-06-06 17:13:19,46842,1259,29.78,48101,246,48347,112789,42.86,1,0,119,89,前鎮區
764,2020-06-06 17:13:20,11733,332,40.07,12065,78,12143,25677,47.29,1,0,24,22,大社區
765,2020-06-06 17:13:20,14623,365,37.53,14988,82,15070,34525,43.65,1,0,28,25,鳥松區
766,2020-06-06 17:13:20,40343,1049,31.13,41392,190,41582,96691,43.01,1,0,89,69,小港區
767,2020-06-06 17:13:20,37810,1041,12.86,38851,196,39047,102658,38.04,1,0,228,85,鳳山區
768,2020-06-06 17:13:20,21935,642,27.73,22577,110,22687,55991,40.52,1,0,72,52,岡山區
769,2020-06-06 17:13:20,13406,341,37.53,13747,74,13821,31386,44.04,1,0,32,28,大樹區
770,2020-06-06 17:13:20,15884,378,16.72,16262,99,16361,39328,41.6,1,0,81,35,大寮區
771,2020-06-06 17:13:20,21200,575,28.66,21775,115,21890,47522,46.06,1,0,47,32,仁武區
772,2020-06-06 17:13:20,22238,614,38.6,22852,176,23028,51076,45.09,1,0,51,46,林園區
773,2020-06-06 17:13:21,2552,92,39.72,2644,21,2665,6425,41.48,1,1,12,12,田寮區
774,2020-06-06 17:13:21,10559,281,44.29,10840,70,10910,23841,45.76,1,1,21,21,阿蓮區
775,2020-06-06 17:13:21,18054,568,42.55,18622,111,18733,42432,44.15,1,1,41,41,路竹區
776,2020-06-06 17:13:21,10618,306,41.88,10924,91,11015,25354,43.44,1,1,25,25,燕巢區
777,2020-06-06 17:13:21,12608,397,38.7,13005,68,13073,24896,52.51,1,0,31,24,橋頭區
778,2020-06-06 17:13:22,10600,315,41.54,10915,59,10974,25515,43.01,1,1,21,21,茄萣區
779,2020-06-06 17:13:22,4202,104,35.92,4306,21,4327,10008,43.24,1,0,12,11,永安區
780,2020-06-06 17:13:22,9770,333,38.93,10103,64,10167,22380,45.43,1,0,24,22,湖內區
781,2020-06-06 17:13:23,1223,56,23.41,1279,16,1295,5224,24.79,1,1,7,7,甲仙區
782,2020-06-06 17:13:23,2644,151,24.25,2795,35,2830,10198,27.75,1,0,12,11,六龜區
783,2020-06-06 17:13:23,6173,193,38.78,6366,48,6414,15918,40.29,1,1,18,18,彌陀區
784,2020-06-06 17:13:23,8582,378,25.16,8960,76,9036,30067,30.05,1,0,32,28,美濃區
785,2020-06-06 17:13:23,10645,446,34.55,11091,74,11165,28738,38.85,1,0,35,33,旗山區
786,2020-06-06 17:13:23,2733,121,26.69,2854,28,2882,10238,28.15,1,1,10,10,杉林區
787,2020-06-06 17:13:23,13365,385,44.15,13750,81,13831,28805,48.02,1,0,28,27,梓官區
788,2020-06-06 17:13:24,3863,145,30.86,4008,56,4064,12517,32.47,1,1,18,18,內門區
789,2020-06-06 17:13:24,60,1,3.95,61,0,61,1520,4.01,1,1,3,3,茂林區
790,2020-06-06 17:13:24,209,7,8.95,216,0,216,2334,9.25,1,1,4,4,那瑪夏區
791,2020-06-06 17:13:24,179,24,5.36,203,2,205,2891,7.09,1,0,8,7,桃源區
792,2020-06-06 17:14:14,601412,16709,26.15,618121,3426,621547,1498536,41.48,38,14,1823,1281,高雄市
793,2020-06-06 17:14:14,9107,221,43.17,9328,57,9385,21094,44.49,1,1,24,24,鹽埕區
794,2020-06-06 17:14:15,49848,1229,17.72,51077,254,51331,116985,43.88,1,0,189,89,三民區
795,2020-06-06 17:14:15,37767,981,24.92,38748,171,38919,94527,41.17,1,0,99,64,楠梓區
796,2020-06-06 17:14:15,15884,378,16.72,16262,99,16361,39328,41.6,1,0,81,35,大寮區
797,2020-06-06 17:14:15,9437,252,39.81,9689,47,9736,23704,41.07,1,1,22,22,前金區
798,2020-06-06 17:14:15,8334,228,34.79,8562,52,8614,18677,46.12,1,0,18,15,旗津區
799,2020-06-06 17:14:15,37810,1041,12.86,38851,196,39047,102658,38.04,1,0,228,85,鳳山區
800,2020-06-06 17:14:15,41207,1055,28.87,42262,207,42469,103476,41.04,1,0,116,87,苓雅區
801,2020-06-06 17:14:15,40343,1049,31.13,41392,190,41582,96691,43.01,1,0,89,69,小港區
802,2020-06-06 17:14:15,13406,341,37.53,13747,74,13821,31386,44.04,1,0,32,28,大樹區
803,2020-06-06 17:14:15,18912,469,16.67,19381,92,19473,48222,40.38,1,0,77,39,鼓山區
804,2020-06-06 17:14:15,17452,443,40.21,17895,96,17991,43397,41.46,1,1,42,42,新興區
805,2020-06-06 17:14:15,46842,1259,29.78,48101,246,48347,112789,42.86,1,0,119,89,前鎮區
806,2020-06-06 17:14:15,22238,614,38.6,22852,176,23028,51076,45.09,1,0,51,46,林園區
807,2020-06-06 17:14:15,11733,332,40.07,12065,78,12143,25677,47.29,1,0,24,22,大社區
808,2020-06-06 17:14:15,34695,932,21.94,35627,163,35790,101510,35.26,1,0,103,73,左營區
809,2020-06-06 17:14:16,21200,575,28.66,21775,115,21890,47522,46.06,1,0,47,32,仁武區
810,2020-06-06 17:14:16,2552,92,39.72,2644,21,2665,6425,41.48,1,1,12,12,田寮區
811,2020-06-06 17:14:16,12608,397,38.7,13005,68,13073,24896,52.51,1,0,31,24,橋頭區
812,2020-06-06 17:14:16,21935,642,27.73,22577,110,22687,55991,40.52,1,0,72,52,岡山區
813,2020-06-06 17:14:16,10618,306,41.88,10924,91,11015,25354,43.44,1,1,25,25,燕巢區
814,2020-06-06 17:14:16,14623,365,37.53,14988,82,15070,34525,43.65,1,0,28,25,鳥松區
815,2020-06-06 17:14:17,4202,104,35.92,4306,21,4327,10008,43.24,1,0,12,11,永安區
816,2020-06-06 17:14:17,10559,281,44.29,10840,70,10910,23841,45.76,1,1,21,21,阿蓮區
817,2020-06-06 17:14:17,6173,193,38.78,6366,48,6414,15918,40.29,1,1,18,18,彌陀區
818,2020-06-06 17:14:17,10600,315,41.54,10915,59,10974,25515,43.01,1,1,21,21,茄萣區
819,2020-06-06 17:14:17,9770,333,38.93,10103,64,10167,22380,45.43,1,0,24,22,湖內區
820,2020-06-06 17:14:17,18054,568,42.55,18622,111,18733,42432,44.15,1,1,41,41,路竹區
821,2020-06-06 17:14:18,10645,446,34.55,11091,74,11165,28738,38.85,1,0,35,33,旗山區
822,2020-06-06 17:14:18,13365,385,44.15,13750,81,13831,28805,48.02,1,0,28,27,梓官區
823,2020-06-06 17:14:18,2644,151,24.25,2795,35,2830,10198,27.75,1,0,12,11,六龜區
824,2020-06-06 17:14:18,8582,378,25.16,8960,76,9036,30067,30.05,1,0,32,28,美濃區
825,2020-06-06 17:14:18,1223,56,23.41,1279,16,1295,5224,24.79,1,1,7,7,甲仙區
826,2020-06-06 17:14:19,209,7,8.95,216,0,216,2334,9.25,1,1,4,4,那瑪夏區
827,2020-06-06 17:14:19,3863,145,30.86,4008,56,4064,12517,32.47,1,1,18,18,內門區
828,2020-06-06 17:14:19,179,24,5.36,203,2,205,2891,7.09,1,0,8,7,桃源區
829,2020-06-06 17:14:19,2733,121,26.69,2854,28,2882,10238,28.15,1,1,10,10,杉林區
830,2020-06-06 17:14:19,60,1,3.95,61,0,61,1520,4.01,1,1,3,3,茂林區
831,2020-06-06 17:15:09,34695,932,21.94,35627,163,35790,101510,35.26,1,0,103,73,左營區
832,2020-06-06 17:15:09,18912,469,16.67,19381,92,19473,48222,40.38,1,0,77,39,鼓山區
833,2020-06-06 17:15:09,9107,221,43.17,9328,57,9385,21094,44.49,1,1,24,24,鹽埕區
834,2020-06-06 17:15:09,601412,16709,26.15,618121,3426,621547,1498536,41.48,38,14,1823,1281,高雄市
835,2020-06-06 17:15:10,9437,252,39.81,9689,47,9736,23704,41.07,1,1,22,22,前金區
836,2020-06-06 17:15:10,17452,443,40.21,17895,96,17991,43397,41.46,1,1,42,42,新興區
837,2020-06-06 17:15:10,24434,672,42.41,25106,191,25297,56392,44.86,1,0,51,50,林園區
838,2020-06-06 17:15:10,37810,1041,12.86,38851,196,39047,102658,38.04,1,0,228,85,鳳山區
839,2020-06-06 17:15:10,46842,1259,29.78,48101,246,48347,112789,42.86,1,0,119,89,前鎮區
840,2020-06-06 17:15:10,41207,1055,28.87,42262,207,42469,103476,41.04,1,0,116,87,苓雅區
841,2020-06-06 17:15:10,37767,981,24.92,38748,171,38919,94527,41.17,1,0,99,64,楠梓區
842,2020-06-06 17:15:10,8334,228,34.79,8562,52,8614,18677,46.12,1,0,18,15,旗津區
843,2020-06-06 17:15:10,15884,378,16.72,16262,99,16361,39328,41.6,1,0,81,35,大寮區
844,2020-06-06 17:15:10,40343,1049,31.13,41392,190,41582,96691,43.01,1,0,89,69,小港區
845,2020-06-06 17:15:10,49848,1229,17.72,51077,254,51331,116985,43.88,1,0,189,89,三民區
846,2020-06-06 17:15:11,21986,597,29.72,22583,118,22701,49358,45.99,1,0,47,33,仁武區
847,2020-06-06 17:15:11,12508,348,42.72,12856,84,12940,27417,47.2,1,0,24,23,大社區
848,2020-06-06 17:15:11,13767,348,38.54,14115,77,14192,32107,44.2,1,0,32,29,大樹區
849,2020-06-06 17:15:12,22871,669,28.91,23540,119,23659,58034,40.77,1,0,72,54,岡山區
850,2020-06-06 17:15:12,15263,379,39.17,15642,84,15726,35977,43.71,1,0,28,26,鳥松區
851,2020-06-06 17:15:12,12608,397,38.7,13005,68,13073,24896,52.51,1,0,31,24,橋頭區
852,2020-06-06 17:15:13,10618,306,41.88,10924,91,11015,25354,43.44,1,1,25,25,燕巢區
853,2020-06-06 17:15:13,10559,281,44.29,10840,70,10910,23841,45.76,1,1,21,21,阿蓮區
854,2020-06-06 17:15:13,2552,92,39.72,2644,21,2665,6425,41.48,1,1,12,12,田寮區
855,2020-06-06 17:15:14,18054,568,42.55,18622,111,18733,42432,44.15,1,1,41,41,路竹區
856,2020-06-06 17:15:14,9770,333,38.93,10103,64,10167,22380,45.43,1,0,24,22,湖內區
857,2020-06-06 17:15:14,10600,315,41.54,10915,59,10974,25515,43.01,1,1,21,21,茄萣區
858,2020-06-06 17:15:15,4202,104,35.92,4306,21,4327,10008,43.24,1,0,12,11,永安區
859,2020-06-06 17:15:15,6173,193,38.78,6366,48,6414,15918,40.29,1,1,18,18,彌陀區
860,2020-06-06 17:15:15,14032,404,46.35,14436,87,14523,30272,47.98,1,1,28,28,梓官區
861,2020-06-06 17:15:16,9197,396,26.96,9593,82,9675,32160,30.08,1,0,32,30,美濃區
862,2020-06-06 17:15:16,10913,458,35.42,11371,75,11446,29638,38.62,1,0,35,34,旗山區
863,2020-06-06 17:15:17,2733,121,26.69,2854,28,2882,10238,28.15,1,1,10,10,杉林區
864,2020-06-06 17:15:17,1223,56,23.41,1279,16,1295,5224,24.79,1,1,7,7,甲仙區
865,2020-06-06 17:15:17,2644,151,24.25,2795,35,2830,10198,27.75,1,0,12,11,六龜區
866,2020-06-06 17:15:18,3863,145,30.86,4008,56,4064,12517,32.47,1,1,18,18,內門區
867,2020-06-06 17:15:18,209,7,8.95,216,0,216,2334,9.25,1,1,4,4,那瑪夏區
868,2020-06-06 17:15:18,60,1,3.95,61,0,61,1520,4.01,1,1,3,3,茂林區
869,2020-06-06 17:15:18,179,24,5.36,203,2,205,2891,7.09,1,0,8,7,桃源區
870,2020-06-06 17:16:08,657162,18118,28.57,675280,3725,679005,1631602,41.62,38,15,1823,1373,高雄市
871,2020-06-06 17:16:08,9107,221,43.17,9328,57,9385,21094,44.49,1,1,24,24,鹽埕區
872,2020-06-06 17:16:09,44599,1149,34.41,45748,212,45960,106163,43.29,1,0,89,75,小港區
873,2020-06-06 17:16:09,17452,443,40.21,17895,96,17991,43397,41.46,1,1,42,42,新興區
874,2020-06-06 17:16:09,57509,1406,20.45,58915,289,59204,134892,43.89,1,0,189,100,三民區
875,2020-06-06 17:16:09,44972,1243,15.29,46215,235,46450,120778,38.46,1,0,228,99,鳳山區
876,2020-06-06 17:16:09,40022,1055,25.31,41077,192,41269,114573,36.02,1,0,103,81,左營區
877,2020-06-06 17:16:09,9437,252,39.81,9689,47,9736,23704,41.07,1,1,22,22,前金區
878,2020-06-06 17:16:09,55785,1481,35.47,57266,283,57549,133376,43.15,1,0,119,102,前鎮區
879,2020-06-06 17:16:09,44677,1173,29.49,45850,208,46058,110942,41.52,1,0,99,75,楠梓區
880,2020-06-06 17:16:09,8334,228,34.79,8562,52,8614,18677,46.12,1,0,18,15,旗津區
881,2020-06-06 17:16:09,20639,515,18.2,21154,98,21252,52440,40.53,1,0,77,42,鼓山區
882,2020-06-06 17:16:09,46378,1174,32.49,47552,238,47790,115725,41.3,1,0,116,96,苓雅區
883,2020-06-06 17:16:10,10600,315,41.54,10915,59,10974,25515,43.01,1,1,21,21,茄萣區
884,2020-06-06 17:16:10,10559,281,44.29,10840,70,10910,23841,45.76,1,1,21,21,阿蓮區
885,2020-06-06 17:16:10,18054,568,42.55,18622,111,18733,42432,44.15,1,1,41,41,路竹區
886,2020-06-06 17:16:10,15263,379,39.17,15642,84,15726,35977,43.71,1,0,28,26,鳥松區
887,2020-06-06 17:16:10,17233,413,18.14,17646,111,17757,42795,41.49,1,0,81,38,大寮區
888,2020-06-06 17:16:10,24434,672,42.41,25106,191,25297,56392,44.86,1,0,51,50,林園區
889,2020-06-06 17:16:10,12508,348,42.72,12856,84,12940,27417,47.2,1,0,24,23,大社區
890,2020-06-06 17:16:10,12608,397,38.7,13005,68,13073,24896,52.51,1,0,31,24,橋頭區
891,2020-06-06 17:16:10,21986,597,29.72,22583,118,22701,49358,45.99,1,0,47,33,仁武區
892,2020-06-06 17:16:10,10618,306,41.88,10924,91,11015,25354,43.44,1,1,25,25,燕巢區
893,2020-06-06 17:16:10,2552,92,39.72,2644,21,2665,6425,41.48,1,1,12,12,田寮區
894,2020-06-06 17:16:10,22871,669,28.91,23540,119,23659,58034,40.77,1,0,72,54,岡山區
895,2020-06-06 17:16:10,13767,348,38.54,14115,77,14192,32107,44.2,1,0,32,29,大樹區
896,2020-06-06 17:16:10,9770,333,38.93,10103,64,10167,22380,45.43,1,0,24,22,湖內區
897,2020-06-06 17:16:11,60,1,3.95,61,0,61,1520,4.01,1,1,3,3,茂林區
898,2020-06-06 17:16:11,6173,193,38.78,6366,48,6414,15918,40.29,1,1,18,18,彌陀區
899,2020-06-06 17:16:11,2733,121,26.69,2854,28,2882,10238,28.15,1,1,10,10,杉林區
900,2020-06-06 17:16:11,3863,145,30.86,4008,56,4064,12517,32.47,1,1,18,18,內門區
901,2020-06-06 17:16:11,9197,396,26.96,9593,82,9675,32160,30.08,1,0,32,30,美濃區
902,2020-06-06 17:16:11,179,24,5.36,203,2,205,2891,7.09,1,0,8,7,桃源區
903,2020-06-06 17:16:11,10913,458,35.42,11371,75,11446,29638,38.62,1,0,35,34,旗山區
904,2020-06-06 17:16:11,209,7,8.95,216,0,216,2334,9.25,1,1,4,4,那瑪夏區
905,2020-06-06 17:16:11,4202,104,35.92,4306,21,4327,10008,43.24,1,0,12,11,永安區
906,2020-06-06 17:16:11,2644,151,24.25,2795,35,2830,10198,27.75,1,0,12,11,六龜區
907,2020-06-06 17:16:11,14032,404,46.35,14436,87,14523,30272,47.98,1,1,28,28,梓官區
908,2020-06-06 17:16:11,1223,56,23.41,1279,16,1295,5224,24.79,1,1,7,7,甲仙區
909,2020-06-06 17:17:01,657162,18118,28.57,675280,3725,679005,1631602,41.62,38,15,1823,1373,高雄市
910,2020-06-06 17:17:02,17233,413,18.14,17646,111,17757,42795,41.49,1,0,81,38,大寮區
911,2020-06-06 17:17:02,8334,228,34.79,8562,52,8614,18677,46.12,1,0,18,15,旗津區
912,2020-06-06 17:17:02,44677,1173,29.49,45850,208,46058,110942,41.52,1,0,99,75,楠梓區
913,2020-06-06 17:17:02,24434,672,42.41,25106,191,25297,56392,44.86,1,0,51,50,林園區
914,2020-06-06 17:17:02,44599,1149,34.41,45748,212,45960,106163,43.29,1,0,89,75,小港區
915,2020-06-06 17:17:02,44972,1243,15.29,46215,235,46450,120778,38.46,1,0,228,99,鳳山區
916,2020-06-06 17:17:02,9107,221,43.17,9328,57,9385,21094,44.49,1,1,24,24,鹽埕區
917,2020-06-06 17:17:02,9437,252,39.81,9689,47,9736,23704,41.07,1,1,22,22,前金區
918,2020-06-06 17:17:02,20639,515,18.2,21154,98,21252,52440,40.53,1,0,77,42,鼓山區
919,2020-06-06 17:17:02,17452,443,40.21,17895,96,17991,43397,41.46,1,1,42,42,新興區
920,2020-06-06 17:17:02,40022,1055,25.31,41077,192,41269,114573,36.02,1,0,103,81,左營區
921,2020-06-06 17:17:02,57509,1406,20.45,58915,289,59204,134892,43.89,1,0,189,100,三民區
922,2020-06-06 17:17:02,55785,1481,35.47,57266,283,57549,133376,43.15,1,0,119,102,前鎮區
923,2020-06-06 17:17:02,13767,348,38.54,14115,77,14192,32107,44.2,1,0,32,29,大樹區
924,2020-06-06 17:17:02,12508,348,42.72,12856,84,12940,27417,47.2,1,0,24,23,大社區
925,2020-06-06 17:17:02,46378,1174,32.49,47552,238,47790,115725,41.3,1,0,116,96,苓雅區
926,2020-06-06 17:17:03,18054,568,42.55,18622,111,18733,42432,44.15,1,1,41,41,路竹區
927,2020-06-06 17:17:03,10618,306,41.88,10924,91,11015,25354,43.44,1,1,25,25,燕巢區
928,2020-06-06 17:17:03,14032,404,46.35,14436,87,14523,30272,47.98,1,1,28,28,梓官區
929,2020-06-06 17:17:03,10913,458,35.42,11371,75,11446,29638,38.62,1,0,35,34,旗山區
930,2020-06-06 17:17:03,4202,104,35.92,4306,21,4327,10008,43.24,1,0,12,11,永安區
931,2020-06-06 17:17:03,15263,379,39.17,15642,84,15726,35977,43.71,1,0,28,26,鳥松區
932,2020-06-06 17:17:03,10559,281,44.29,10840,70,10910,23841,45.76,1,1,21,21,阿蓮區
933,2020-06-06 17:17:03,6173,193,38.78,6366,48,6414,15918,40.29,1,1,18,18,彌陀區
934,2020-06-06 17:17:03,21986,597,29.72,22583,118,22701,49358,45.99,1,0,47,33,仁武區
935,2020-06-06 17:17:03,12608,397,38.7,13005,68,13073,24896,52.51,1,0,31,24,橋頭區
936,2020-06-06 17:17:03,22871,669,28.91,23540,119,23659,58034,40.77,1,0,72,54,岡山區
937,2020-06-06 17:17:03,2552,92,39.72,2644,21,2665,6425,41.48,1,1,12,12,田寮區
938,2020-06-06 17:17:03,9770,333,38.93,10103,64,10167,22380,45.43,1,0,24,22,湖內區
939,2020-06-06 17:17:03,10600,315,41.54,10915,59,10974,25515,43.01,1,1,21,21,茄萣區
940,2020-06-06 17:17:04,2733,121,26.69,2854,28,2882,10238,28.15,1,1,10,10,杉林區
941,2020-06-06 17:17:04,1223,56,23.41,1279,16,1295,5224,24.79,1,1,7,7,甲仙區
942,2020-06-06 17:17:04,179,24,5.36,203,2,205,2891,7.09,1,0,8,7,桃源區
943,2020-06-06 17:17:04,60,1,3.95,61,0,61,1520,4.01,1,1,3,3,茂林區
944,2020-06-06 17:17:04,209,7,8.95,216,0,216,2334,9.25,1,1,4,4,那瑪夏區
945,2020-06-06 17:17:04,9197,396,26.96,9593,82,9675,32160,30.08,1,0,32,30,美濃區
946,2020-06-06 17:17:04,3863,145,30.86,4008,56,4064,12517,32.47,1,1,18,18,內門區
947,2020-06-06 17:17:04,2644,151,24.25,2795,35,2830,10198,27.75,1,0,12,11,六龜區
948,2020-06-06 17:17:54,657162,18118,28.57,675280,3725,679005,1631602,41.62,38,15,1823,1373,高雄市
949,2020-06-06 17:17:55,55785,1481,35.47,57266,283,57549,133376,43.15,1,0,119,102,前鎮區
950,2020-06-06 17:17:55,8334,228,34.79,8562,52,8614,18677,46.12,1,0,18,15,旗津區
951,2020-06-06 17:17:55,57509,1406,20.45,58915,289,59204,134892,43.89,1,0,189,100,三民區
952,2020-06-06 17:17:55,9437,252,39.81,9689,47,9736,23704,41.07,1,1,22,22,前金區
953,2020-06-06 17:17:55,44677,1173,29.49,45850,208,46058,110942,41.52,1,0,99,75,楠梓區
954,2020-06-06 17:17:55,40022,1055,25.31,41077,192,41269,114573,36.02,1,0,103,81,左營區
955,2020-06-06 17:17:55,9107,221,43.17,9328,57,9385,21094,44.49,1,1,24,24,鹽埕區
956,2020-06-06 17:17:55,20639,515,18.2,21154,98,21252,52440,40.53,1,0,77,42,鼓山區
957,2020-06-06 17:17:55,44599,1149,34.41,45748,212,45960,106163,43.29,1,0,89,75,小港區
958,2020-06-06 17:17:55,17452,443,40.21,17895,96,17991,43397,41.46,1,1,42,42,新興區
959,2020-06-06 17:17:55,46378,1174,32.49,47552,238,47790,115725,41.3,1,0,116,96,苓雅區
960,2020-06-06 17:17:56,10600,315,41.54,10915,59,10974,25515,43.01,1,1,21,21,茄萣區
961,2020-06-06 17:17:56,12608,397,38.7,13005,68,13073,24896,52.51,1,0,31,24,橋頭區
962,2020-06-06 17:17:56,10559,281,44.29,10840,70,10910,23841,45.76,1,1,21,21,阿蓮區
963,2020-06-06 17:17:56,15263,379,39.17,15642,84,15726,35977,43.71,1,0,28,26,鳥松區
964,2020-06-06 17:17:56,12508,348,42.72,12856,84,12940,27417,47.2,1,0,24,23,大社區
965,2020-06-06 17:17:56,24434,672,42.41,25106,191,25297,56392,44.86,1,0,51,50,林園區
966,2020-06-06 17:17:56,18054,568,42.55,18622,111,18733,42432,44.15,1,1,41,41,路竹區
967,2020-06-06 17:17:56,10618,306,41.88,10924,91,11015,25354,43.44,1,1,25,25,燕巢區
968,2020-06-06 17:17:56,21986,597,29.72,22583,118,22701,49358,45.99,1,0,47,33,仁武區
969,2020-06-06 17:17:56,2552,92,39.72,2644,21,2665,6425,41.48,1,1,12,12,田寮區
970,2020-06-06 17:17:56,9770,333,38.93,10103,64,10167,22380,45.43,1,0,24,22,湖內區
971,2020-06-06 17:17:56,22871,669,28.91,23540,119,23659,58034,40.77,1,0,72,54,岡山區
972,2020-06-06 17:17:56,13767,348,38.54,14115,77,14192,32107,44.2,1,0,32,29,大樹區
973,2020-06-06 17:17:56,17233,413,18.14,17646,111,17757,42795,41.49,1,0,81,38,大寮區
974,2020-06-06 17:17:56,44972,1243,15.29,46215,235,46450,120778,38.46,1,0,228,99,鳳山區
975,2020-06-06 17:17:57,4202,104,35.92,4306,21,4327,10008,43.24,1,0,12,11,永安區
976,2020-06-06 17:17:57,1223,56,23.41,1279,16,1295,5224,24.79,1,1,7,7,甲仙區
977,2020-06-06 17:17:57,3863,145,30.86,4008,56,4064,12517,32.47,1,1,18,18,內門區
978,2020-06-06 17:17:57,9197,396,26.96,9593,82,9675,32160,30.08,1,0,32,30,美濃區
979,2020-06-06 17:17:57,2644,151,24.25,2795,35,2830,10198,27.75,1,0,12,11,六龜區
980,2020-06-06 17:17:57,2733,121,26.69,2854,28,2882,10238,28.15,1,1,10,10,杉林區
981,2020-06-06 17:17:57,6173,193,38.78,6366,48,6414,15918,40.29,1,1,18,18,彌陀區
982,2020-06-06 17:17:57,10913,458,35.42,11371,75,11446,29638,38.62,1,0,35,34,旗山區
983,2020-06-06 17:17:57,14032,404,46.35,14436,87,14523,30272,47.98,1,1,28,28,梓官區
984,2020-06-06 17:17:58,179,24,5.36,203,2,205,2891,7.09,1,0,8,7,桃源區
985,2020-06-06 17:17:58,209,7,8.95,216,0,216,2334,9.25,1,1,4,4,那瑪夏區
986,2020-06-06 17:17:58,60,1,3.95,61,0,61,1520,4.01,1,1,3,3,茂林區
987,2020-06-06 17:18:48,704882,19325,30.65,724207,3937,728144,1745922,41.71,38,16,1823,1449,高雄市
988,2020-06-06 17:18:48,9107,221,43.17,9328,57,9385,21094,44.49,1,1,24,24,鹽埕區
989,2020-06-06 17:18:48,23726,571,20.92,24297,107,24404,60289,40.48,1,0,77,47,鼓山區
990,2020-06-06 17:18:48,65275,1597,23.21,66872,335,67207,152700,44.01,1,0,189,111,三民區
991,2020-06-06 17:18:48,9437,252,39.81,9689,47,9736,23704,41.07,1,1,22,22,前金區
992,2020-06-06 17:18:48,59704,1594,37.96,61298,303,61601,142182,43.33,1,0,119,108,前鎮區
993,2020-06-06 17:18:48,44214,1146,27.96,45360,203,45563,124968,36.46,1,0,103,86,左營區
994,2020-06-06 17:18:48,47820,1213,33.5,49033,248,49281,119836,41.12,1,0,116,99,苓雅區
995,2020-06-06 17:18:48,48998,1298,32.34,50296,224,50520,121392,41.62,1,0,99,81,楠梓區
996,2020-06-06 17:18:48,17452,443,40.21,17895,96,17991,43397,41.46,1,1,42,42,新興區
997,2020-06-06 17:18:49,24389,698,30.83,25087,127,25214,61600,40.93,1,0,72,57,岡山區
998,2020-06-06 17:18:49,15938,396,40.91,16334,89,16423,37256,44.08,1,0,28,27,鳥松區
999,2020-06-06 17:18:49,52236,1424,17.76,53660,265,53925,139257,38.72,1,0,228,114,鳳山區
1000,2020-06-06 17:18:49,9736,262,40.64,9998,55,10053,21952,45.8,1,0,18,17,旗津區
1001,2020-06-06 17:18:49,14308,361,40.06,14669,81,14750,33407,44.15,1,0,32,30,大樹區
1002,2020-06-06 17:18:49,18606,450,19.59,19056,114,19170,46325,41.38,1,0,81,41,大寮區
1003,2020-06-06 17:18:49,10618,306,41.88,10924,91,11015,25354,43.44,1,1,25,25,燕巢區
1004,2020-06-06 17:18:49,14317,465,43.95,14782,79,14861,28427,52.28,1,0,31,27,橋頭區
1005,2020-06-06 17:18:49,13320,363,45.49,13683,89,13772,29282,47.03,1,1,24,24,大社區
1006,2020-06-06 17:18:49,24434,672,42.41,25106,191,25297,56392,44.86,1,0,51,50,林園區
1007,2020-06-06 17:18:49,47443,1219,36.61,48662,220,48882,112807,43.33,1,0,89,79,小港區
1008,2020-06-06 17:18:49,26465,710,35.78,27175,137,27312,59492,45.91,1,0,47,39,仁武區
1009,2020-06-06 17:18:50,9770,333,38.93,10103,64,10167,22380,45.43,1,0,24,22,湖內區
1010,2020-06-06 17:18:50,10600,315,41.54,10915,59,10974,25515,43.01,1,1,21,21,茄萣區
1011,2020-06-06 17:18:50,10559,281,44.29,10840,70,10910,23841,45.76,1,1,21,21,阿蓮區
1012,2020-06-06 17:18:50,18054,568,42.55,18622,111,18733,42432,44.15,1,1,41,41,路竹區
1013,2020-06-06 17:18:50,10913,458,35.42,11371,75,11446,29638,38.62,1,0,35,34,旗山區
1014,2020-06-06 17:18:50,6173,193,38.78,6366,48,6414,15918,40.29,1,1,18,18,彌陀區
1015,2020-06-06 17:18:50,1223,56,23.41,1279,16,1295,5224,24.79,1,1,7,7,甲仙區
1016,2020-06-06 17:18:50,9573,411,28.06,9984,86,10070,33458,30.1,1,0,32,31,美濃區
1017,2020-06-06 17:18:50,2552,92,39.72,2644,21,2665,6425,41.48,1,1,12,12,田寮區
1018,2020-06-06 17:18:50,14032,404,46.35,14436,87,14523,30272,47.98,1,1,28,28,梓官區
1019,2020-06-06 17:18:50,2733,121,26.69,2854,28,2882,10238,28.15,1,1,10,10,杉林區
1020,2020-06-06 17:18:50,4202,104,35.92,4306,21,4327,10008,43.24,1,0,12,11,永安區
1021,2020-06-06 17:18:50,2644,151,24.25,2795,35,2830,10198,27.75,1,0,12,11,六龜區
1022,2020-06-06 17:18:51,60,1,3.95,61,0,61,1520,4.01,1,1,3,3,茂林區
1023,2020-06-06 17:18:51,209,7,8.95,216,0,216,2334,9.25,1,1,4,4,那瑪夏區
1024,2020-06-06 17:18:51,3863,145,30.86,4008,56,4064,12517,32.47,1,1,18,18,內門區
1025,2020-06-06 17:18:51,179,24,5.36,203,2,205,2891,7.09,1,0,8,7,桃源區
1026,2020-06-06 17:19:41,9107,221,43.17,9328,57,9385,21094,44.49,1,1,24,24,鹽埕區
1027,2020-06-06 17:19:41,23726,571,20.92,24297,107,24404,60289,40.48,1,0,77,47,鼓山區
1028,2020-06-06 17:19:41,704882,19325,30.65,724207,3937,728144,1745922,41.71,38,16,1823,1449,高雄市
1029,2020-06-06 17:19:42,17452,443,40.21,17895,96,17991,43397,41.46,1,1,42,42,新興區
1030,2020-06-06 17:19:42,65275,1597,23.21,66872,335,67207,152700,44.01,1,0,189,111,三民區
1031,2020-06-06 17:19:42,44214,1146,27.96,45360,203,45563,124968,36.46,1,0,103,86,左營區
1032,2020-06-06 17:19:42,47820,1213,33.5,49033,248,49281,119836,41.12,1,0,116,99,苓雅區
1033,2020-06-06 17:19:42,9736,262,40.64,9998,55,10053,21952,45.8,1,0,18,17,旗津區
1034,2020-06-06 17:19:42,59704,1594,37.96,61298,303,61601,142182,43.33,1,0,119,108,前鎮區
1035,2020-06-06 17:19:42,9437,252,39.81,9689,47,9736,23704,41.07,1,1,22,22,前金區
1036,2020-06-06 17:19:42,48998,1298,32.34,50296,224,50520,121392,41.62,1,0,99,81,楠梓區
1037,2020-06-06 17:19:43,13320,363,45.49,13683,89,13772,29282,47.03,1,1,24,24,大社區
1038,2020-06-06 17:19:43,47443,1219,36.61,48662,220,48882,112807,43.33,1,0,89,79,小港區
1039,2020-06-06 17:19:43,18606,450,19.59,19056,114,19170,46325,41.38,1,0,81,41,大寮區
1040,2020-06-06 17:19:43,52236,1424,17.76,53660,265,53925,139257,38.72,1,0,228,114,鳳山區
1041,2020-06-06 17:19:43,24434,672,42.41,25106,191,25297,56392,44.86,1,0,51,50,林園區
1042,2020-06-06 17:19:43,26465,710,35.78,27175,137,27312,59492,45.91,1,0,47,39,仁武區
1043,2020-06-06 17:19:43,14308,361,40.06,14669,81,14750,33407,44.15,1,0,32,30,大樹區
1044,2020-06-06 17:19:44,24389,698,30.83,25087,127,25214,61600,40.93,1,0,72,57,岡山區
1045,2020-06-06 17:19:44,2552,92,39.72,2644,21,2665,6425,41.48,1,1,12,12,田寮區
1046,2020-06-06 17:19:44,18054,568,42.55,18622,111,18733,42432,44.15,1,1,41,41,路竹區
1047,2020-06-06 17:19:44,14317,465,43.95,14782,79,14861,28427,52.28,1,0,31,27,橋頭區
1048,2020-06-06 17:19:44,15938,396,40.91,16334,89,16423,37256,44.08,1,0,28,27,鳥松區
1049,2020-06-06 17:19:44,10559,281,44.29,10840,70,10910,23841,45.76,1,1,21,21,阿蓮區
1050,2020-06-06 17:19:44,10618,306,41.88,10924,91,11015,25354,43.44,1,1,25,25,燕巢區
1051,2020-06-06 17:19:45,6173,193,38.78,6366,48,6414,15918,40.29,1,1,18,18,彌陀區
1052,2020-06-06 17:19:45,4202,104,35.92,4306,21,4327,10008,43.24,1,0,12,11,永安區
1053,2020-06-06 17:19:45,9770,333,38.93,10103,64,10167,22380,45.43,1,0,24,22,湖內區
1054,2020-06-06 17:19:45,14032,404,46.35,14436,87,14523,30272,47.98,1,1,28,28,梓官區
1055,2020-06-06 17:19:45,10600,315,41.54,10915,59,10974,25515,43.01,1,1,21,21,茄萣區
1056,2020-06-06 17:19:46,2644,151,24.25,2795,35,2830,10198,27.75,1,0,12,11,六龜區
1057,2020-06-06 17:19:46,10913,458,35.42,11371,75,11446,29638,38.62,1,0,35,34,旗山區
1058,2020-06-06 17:19:46,1223,56,23.41,1279,16,1295,5224,24.79,1,1,7,7,甲仙區
1059,2020-06-06 17:19:46,9573,411,28.06,9984,86,10070,33458,30.1,1,0,32,31,美濃區
1060,2020-06-06 17:19:47,209,7,8.95,216,0,216,2334,9.25,1,1,4,4,那瑪夏區
1061,2020-06-06 17:19:47,3863,145,30.86,4008,56,4064,12517,32.47,1,1,18,18,內門區
1062,2020-06-06 17:19:47,179,24,5.36,203,2,205,2891,7.09,1,0,8,7,桃源區
1063,2020-06-06 17:19:47,60,1,3.95,61,0,61,1520,4.01,1,1,3,3,茂林區
1064,2020-06-06 17:19:47,2733,121,26.69,2854,28,2882,10238,28.15,1,1,10,10,杉林區
1065,2020-06-06 17:20:37,23726,571,20.92,24297,107,24404,60289,40.48,1,0,77,47,鼓山區
1066,2020-06-06 17:20:37,704882,19325,30.65,724207,3937,728144,1745922,41.71,38,16,1823,1449,高雄市
1067,2020-06-06 17:20:37,9107,221,43.17,9328,57,9385,21094,44.49,1,1,24,24,鹽埕區
1068,2020-06-06 17:20:38,44214,1146,27.96,45360,203,45563,124968,36.46,1,0,103,86,左營區
1069,2020-06-06 17:20:38,48998,1298,32.34,50296,224,50520,121392,41.62,1,0,99,81,楠梓區
1070,2020-06-06 17:20:38,47820,1213,33.5,49033,248,49281,119836,41.12,1,0,116,99,苓雅區
1071,2020-06-06 17:20:38,17452,443,40.21,17895,96,17991,43397,41.46,1,1,42,42,新興區
1072,2020-06-06 17:20:38,9437,252,39.81,9689,47,9736,23704,41.07,1,1,22,22,前金區
1073,2020-06-06 17:20:38,65275,1597,23.21,66872,335,67207,152700,44.01,1,0,189,111,三民區
1074,2020-06-06 17:20:38,59704,1594,37.96,61298,303,61601,142182,43.33,1,0,119,108,前鎮區
1075,2020-06-06 17:20:39,9736,262,40.64,9998,55,10053,21952,45.8,1,0,18,17,旗津區
1076,2020-06-06 17:20:39,14308,361,40.06,14669,81,14750,33407,44.15,1,0,32,30,大樹區
1077,2020-06-06 17:20:39,52236,1424,17.76,53660,265,53925,139257,38.72,1,0,228,114,鳳山區
1078,2020-06-06 17:20:39,13320,363,45.49,13683,89,13772,29282,47.03,1,1,24,24,大社區
1079,2020-06-06 17:20:39,47443,1219,36.61,48662,220,48882,112807,43.33,1,0,89,79,小港區
1080,2020-06-06 17:20:39,18606,450,19.59,19056,114,19170,46325,41.38,1,0,81,41,大寮區
1081,2020-06-06 17:20:39,24434,672,42.41,25106,191,25297,56392,44.86,1,0,51,50,林園區
1082,2020-06-06 17:20:40,24389,698,30.83,25087,127,25214,61600,40.93,1,0,72,57,岡山區
1083,2020-06-06 17:20:40,14317,465,43.95,14782,79,14861,28427,52.28,1,0,31,27,橋頭區
1084,2020-06-06 17:20:40,10618,306,41.88,10924,91,11015,25354,43.44,1,1,25,25,燕巢區
1085,2020-06-06 17:20:40,15938,396,40.91,16334,89,16423,37256,44.08,1,0,28,27,鳥松區
1086,2020-06-06 17:20:40,26465,710,35.78,27175,137,27312,59492,45.91,1,0,47,39,仁武區
1087,2020-06-06 17:20:41,2552,92,39.72,2644,21,2665,6425,41.48,1,1,12,12,田寮區
1088,2020-06-06 17:20:41,18054,568,42.55,18622,111,18733,42432,44.15,1,1,41,41,路竹區
1089,2020-06-06 17:20:41,10600,315,41.54,10915,59,10974,25515,43.01,1,1,21,21,茄萣區
1090,2020-06-06 17:20:41,6173,193,38.78,6366,48,6414,15918,40.29,1,1,18,18,彌陀區
1091,2020-06-06 17:20:41,14032,404,46.35,14436,87,14523,30272,47.98,1,1,28,28,梓官區
1092,2020-06-06 17:20:41,9573,411,28.06,9984,86,10070,33458,30.1,1,0,32,31,美濃區
1093,2020-06-06 17:20:41,10913,458,35.42,11371,75,11446,29638,38.62,1,0,35,34,旗山區
1094,2020-06-06 17:20:41,2644,151,24.25,2795,35,2830,10198,27.75,1,0,12,11,六龜區
1095,2020-06-06 17:20:41,4202,104,35.92,4306,21,4327,10008,43.24,1,0,12,11,永安區
1096,2020-06-06 17:20:41,9770,333,38.93,10103,64,10167,22380,45.43,1,0,24,22,湖內區
1097,2020-06-06 17:20:41,10559,281,44.29,10840,70,10910,23841,45.76,1,1,21,21,阿蓮區
1098,2020-06-06 17:20:42,3863,145,30.86,4008,56,4064,12517,32.47,1,1,18,18,內門區
1099,2020-06-06 17:20:42,2733,121,26.69,2854,28,2882,10238,28.15,1,1,10,10,杉林區
1100,2020-06-06 17:20:42,60,1,3.95,61,0,61,1520,4.01,1,1,3,3,茂林區
1101,2020-06-06 17:20:42,209,7,8.95,216,0,216,2334,9.25,1,1,4,4,那瑪夏區
1102,2020-06-06 17:20:42,1223,56,23.41,1279,16,1295,5224,24.79,1,1,7,7,甲仙區
1103,2020-06-06 17:20:42,179,24,5.36,203,2,205,2891,7.09,1,0,8,7,桃源區
1104,2020-06-06 17:21:32,9107,221,43.17,9328,57,9385,21094,44.49,1,1,24,24,鹽埕區
1105,2020-06-06 17:21:32,742793,20300,32.3,763093,4129,767222,1837037,41.76,38,19,1823,1509,高雄市
1106,2020-06-06 17:21:33,51169,1360,33.77,52529,237,52766,126293,41.78,1,0,99,84,楠梓區
1107,2020-06-06 17:21:33,59498,1614,20.23,61112,303,61415,157220,39.06,1,0,228,127,鳳山區
1108,2020-06-06 17:21:33,70973,1727,25.23,72700,355,73055,166994,43.75,1,0,189,120,三民區
1109,2020-06-06 17:21:33,26564,628,23.42,27192,115,27307,66735,40.92,1,0,77,51,鼓山區
1110,2020-06-06 17:21:33,49572,1270,31.35,50842,226,51068,138408,36.9,1,0,103,93,左營區
1111,2020-06-06 17:21:33,10658,295,44.49,10953,58,11011,23954,45.97,1,1,18,18,旗津區
1112,2020-06-06 17:21:33,60507,1619,38.47,62126,308,62434,143879,43.39,1,0,119,109,前鎮區
1113,2020-06-06 17:21:33,17452,443,40.21,17895,96,17991,43397,41.46,1,1,42,42,新興區
1114,2020-06-06 17:21:33,49483,1281,38.18,50764,231,50995,117323,43.47,1,0,89,82,小港區
1115,2020-06-06 17:21:33,9437,252,39.81,9689,47,9736,23704,41.07,1,1,22,22,前金區
1116,2020-06-06 17:21:33,51128,1285,35.82,52413,267,52680,128317,41.05,1,0,116,105,苓雅區
1117,2020-06-06 17:21:33,24434,672,42.41,25106,191,25297,56392,44.86,1,0,51,50,林園區
1118,2020-06-06 17:21:34,10600,315,41.54,10915,59,10974,25515,43.01,1,1,21,21,茄萣區
1119,2020-06-06 17:21:34,14317,465,43.95,14782,79,14861,28427,52.28,1,0,31,27,橋頭區
1120,2020-06-06 17:21:34,10618,306,41.88,10924,91,11015,25354,43.44,1,1,25,25,燕巢區
1121,2020-06-06 17:21:34,19808,481,20.85,20289,119,20408,49269,41.42,1,0,81,43,大寮區
1122,2020-06-06 17:21:34,10559,281,44.29,10840,70,10910,23841,45.76,1,1,21,21,阿蓮區
1123,2020-06-06 17:21:34,4202,104,35.92,4306,21,4327,10008,43.24,1,0,12,11,永安區
1124,2020-06-06 17:21:34,15938,396,40.91,16334,89,16423,37256,44.08,1,0,28,27,鳥松區
1125,2020-06-06 17:21:34,26066,737,32.95,26803,141,26944,65452,41.17,1,0,72,61,岡山區
1126,2020-06-06 17:21:34,14785,374,41.39,15159,88,15247,34342,44.4,1,0,32,31,大樹區
1127,2020-06-06 17:21:34,2552,92,39.72,2644,21,2665,6425,41.48,1,1,12,12,田寮區
1128,2020-06-06 17:21:34,13320,363,45.49,13683,89,13772,29282,47.03,1,1,24,24,大社區
1129,2020-06-06 17:21:34,28975,795,39.17,29770,149,29919,65250,45.85,1,0,47,42,仁武區
1130,2020-06-06 17:21:34,10929,369,43.55,11298,75,11373,25097,45.32,1,1,24,24,湖內區
1131,2020-06-06 17:21:34,18054,568,42.55,18622,111,18733,42432,44.15,1,1,41,41,路竹區
1132,2020-06-06 17:21:35,2733,121,26.69,2854,28,2882,10238,28.15,1,1,10,10,杉林區
1133,2020-06-06 17:21:35,179,24,5.36,203,2,205,2891,7.09,1,0,8,7,桃源區
1134,2020-06-06 17:21:35,6173,193,38.78,6366,48,6414,15918,40.29,1,1,18,18,彌陀區
1135,2020-06-06 17:21:35,11399,474,37.0,11873,78,11951,30807,38.79,1,1,35,35,旗山區
1136,2020-06-06 17:21:35,60,1,3.95,61,0,61,1520,4.01,1,1,3,3,茂林區
1137,2020-06-06 17:21:35,3863,145,30.86,4008,56,4064,12517,32.47,1,1,18,18,內門區
1138,2020-06-06 17:21:35,1223,56,23.41,1279,16,1295,5224,24.79,1,1,7,7,甲仙區
1139,2020-06-06 17:21:35,14032,404,46.35,14436,87,14523,30272,47.98,1,1,28,28,梓官區
1140,2020-06-06 17:21:35,9573,411,28.06,9984,86,10070,33458,30.1,1,0,32,31,美濃區
1141,2020-06-06 17:21:35,2644,151,24.25,2795,35,2830,10198,27.75,1,0,12,11,六龜區
1142,2020-06-06 17:21:35,209,7,8.95,216,0,216,2334,9.25,1,1,4,4,那瑪夏區
1143,2020-06-06 17:22:26,51128,1285,35.82,52413,267,52680,128317,41.05,1,0,116,105,苓雅區
1144,2020-06-06 17:22:26,17452,443,40.21,17895,96,17991,43397,41.46,1,1,42,42,新興區
1145,2020-06-06 17:22:26,9437,252,39.81,9689,47,9736,23704,41.07,1,1,22,22,前金區
1146,2020-06-06 17:22:26,9107,221,43.17,9328,57,9385,21094,44.49,1,1,24,24,鹽埕區
1147,2020-06-06 17:22:26,51169,1360,33.77,52529,237,52766,126293,41.78,1,0,99,84,楠梓區
1148,2020-06-06 17:22:26,26564,628,23.42,27192,115,27307,66735,40.92,1,0,77,51,鼓山區
1149,2020-06-06 17:22:26,742793,20300,32.3,763093,4129,767222,1837037,41.76,38,19,1823,1509,高雄市
1150,2020-06-06 17:22:26,60507,1619,38.47,62126,308,62434,143879,43.39,1,0,119,109,前鎮區
1151,2020-06-06 17:22:26,70973,1727,25.23,72700,355,73055,166994,43.75,1,0,189,120,三民區
1152,2020-06-06 17:22:26,49483,1281,38.18,50764,231,50995,117323,43.47,1,0,89,82,小港區
1153,2020-06-06 17:22:26,49572,1270,31.35,50842,226,51068,138408,36.9,1,0,103,93,左營區
1154,2020-06-06 17:22:26,10658,295,44.49,10953,58,11011,23954,45.97,1,1,18,18,旗津區
1155,2020-06-06 17:22:27,19808,481,20.85,20289,119,20408,49269,41.42,1,0,81,43,大寮區
1156,2020-06-06 17:22:27,59498,1614,20.23,61112,303,61415,157220,39.06,1,0,228,127,鳳山區
1157,2020-06-06 17:22:27,24434,672,42.41,25106,191,25297,56392,44.86,1,0,51,50,林園區
1158,2020-06-06 17:22:27,14785,374,41.39,15159,88,15247,34342,44.4,1,0,32,31,大樹區
1159,2020-06-06 17:22:28,15938,396,40.91,16334,89,16423,37256,44.08,1,0,28,27,鳥松區
1160,2020-06-06 17:22:28,13320,363,45.49,13683,89,13772,29282,47.03,1,1,24,24,大社區
1161,2020-06-06 17:22:28,28975,795,39.17,29770,149,29919,65250,45.85,1,0,47,42,仁武區
1162,2020-06-06 17:22:29,18054,568,42.55,18622,111,18733,42432,44.15,1,1,41,41,路竹區
1163,2020-06-06 17:22:29,10618,306,41.88,10924,91,11015,25354,43.44,1,1,25,25,燕巢區
1164,2020-06-06 17:22:29,2552,92,39.72,2644,21,2665,6425,41.48,1,1,12,12,田寮區
1165,2020-06-06 17:22:29,26066,737,32.95,26803,141,26944,65452,41.17,1,0,72,61,岡山區
1166,2020-06-06 17:22:29,14317,465,43.95,14782,79,14861,28427,52.28,1,0,31,27,橋頭區
1167,2020-06-06 17:22:29,10559,281,44.29,10840,70,10910,23841,45.76,1,1,21,21,阿蓮區
1168,2020-06-06 17:22:30,1223,56,23.41,1279,16,1295,5224,24.79,1,1,7,7,甲仙區
1169,2020-06-06 17:22:30,2644,151,24.25,2795,35,2830,10198,27.75,1,0,12,11,六龜區
1170,2020-06-06 17:22:30,14032,404,46.35,14436,87,14523,30272,47.98,1,1,28,28,梓官區
1171,2020-06-06 17:22:30,10929,369,43.55,11298,75,11373,25097,45.32,1,1,24,24,湖內區
1172,2020-06-06 17:22:30,11399,474,37.0,11873,78,11951,30807,38.79,1,1,35,35,旗山區
1173,2020-06-06 17:22:30,4202,104,35.92,4306,21,4327,10008,43.24,1,0,12,11,永安區
1174,2020-06-06 17:22:30,9573,411,28.06,9984,86,10070,33458,30.1,1,0,32,31,美濃區
1175,2020-06-06 17:22:30,10600,315,41.54,10915,59,10974,25515,43.01,1,1,21,21,茄萣區
1176,2020-06-06 17:22:30,6173,193,38.78,6366,48,6414,15918,40.29,1,1,18,18,彌陀區
1177,2020-06-06 17:22:31,179,24,5.36,203,2,205,2891,7.09,1,0,8,7,桃源區
1178,2020-06-06 17:22:31,60,1,3.95,61,0,61,1520,4.01,1,1,3,3,茂林區
1179,2020-06-06 17:22:31,2733,121,26.69,2854,28,2882,10238,28.15,1,1,10,10,杉林區
1180,2020-06-06 17:22:31,209,7,8.95,216,0,216,2334,9.25,1,1,4,4,那瑪夏區
1181,2020-06-06 17:22:31,3863,145,30.86,4008,56,4064,12517,32.47,1,1,18,18,內門區
1182,2020-06-06 17:23:21,9107,221,43.17,9328,57,9385,21094,44.49,1,1,24,24,鹽埕區
1183,2020-06-06 17:23:21,742793,20300,32.3,763093,4129,767222,1837037,41.76,38,19,1823,1509,高雄市
1184,2020-06-06 17:23:22,51128,1285,35.82,52413,267,52680,128317,41.05,1,0,116,105,苓雅區
1185,2020-06-06 17:23:22,17452,443,40.21,17895,96,17991,43397,41.46,1,1,42,42,新興區
1186,2020-06-06 17:23:22,49572,1270,31.35,50842,226,51068,138408,36.9,1,0,103,93,左營區
1187,2020-06-06 17:23:22,9437,252,39.81,9689,47,9736,23704,41.07,1,1,22,22,前金區
1188,2020-06-06 17:23:22,26564,628,23.42,27192,115,27307,66735,40.92,1,0,77,51,鼓山區
1189,2020-06-06 17:23:22,70973,1727,25.23,72700,355,73055,166994,43.75,1,0,189,120,三民區
1190,2020-06-06 17:23:22,60507,1619,38.47,62126,308,62434,143879,43.39,1,0,119,109,前鎮區
1191,2020-06-06 17:23:22,51169,1360,33.77,52529,237,52766,126293,41.78,1,0,99,84,楠梓區
1192,2020-06-06 17:23:23,13320,363,45.49,13683,89,13772,29282,47.03,1,1,24,24,大社區
1193,2020-06-06 17:23:23,14785,374,41.39,15159,88,15247,34342,44.4,1,0,32,31,大樹區
1194,2020-06-06 17:23:23,10658,295,44.49,10953,58,11011,23954,45.97,1,1,18,18,旗津區
1195,2020-06-06 17:23:23,19808,481,20.85,20289,119,20408,49269,41.42,1,0,81,43,大寮區
1196,2020-06-06 17:23:23,24434,672,42.41,25106,191,25297,56392,44.86,1,0,51,50,林園區
1197,2020-06-06 17:23:23,49483,1281,38.18,50764,231,50995,117323,43.47,1,0,89,82,小港區
1198,2020-06-06 17:23:23,59498,1614,20.23,61112,303,61415,157220,39.06,1,0,228,127,鳳山區
1199,2020-06-06 17:23:24,28975,795,39.17,29770,149,29919,65250,45.85,1,0,47,42,仁武區
1200,2020-06-06 17:23:24,10929,369,43.55,11298,75,11373,25097,45.32,1,1,24,24,湖內區
1201,2020-06-06 17:23:24,2552,92,39.72,2644,21,2665,6425,41.48,1,1,12,12,田寮區
1202,2020-06-06 17:23:24,15938,396,40.91,16334,89,16423,37256,44.08,1,0,28,27,鳥松區
1203,2020-06-06 17:23:24,14317,465,43.95,14782,79,14861,28427,52.28,1,0,31,27,橋頭區
1204,2020-06-06 17:23:24,18054,568,42.55,18622,111,18733,42432,44.15,1,1,41,41,路竹區
1205,2020-06-06 17:23:24,10600,315,41.54,10915,59,10974,25515,43.01,1,1,21,21,茄萣區
1206,2020-06-06 17:23:24,26066,737,32.95,26803,141,26944,65452,41.17,1,0,72,61,岡山區
1207,2020-06-06 17:23:24,10559,281,44.29,10840,70,10910,23841,45.76,1,1,21,21,阿蓮區
1208,2020-06-06 17:23:24,10618,306,41.88,10924,91,11015,25354,43.44,1,1,25,25,燕巢區
1209,2020-06-06 17:23:25,2644,151,24.25,2795,35,2830,10198,27.75,1,0,12,11,六龜區
1210,2020-06-06 17:23:25,60,1,3.95,61,0,61,1520,4.01,1,1,3,3,茂林區
1211,2020-06-06 17:23:25,9573,411,28.06,9984,86,10070,33458,30.1,1,0,32,31,美濃區
1212,2020-06-06 17:23:25,6173,193,38.78,6366,48,6414,15918,40.29,1,1,18,18,彌陀區
1213,2020-06-06 17:23:25,11399,474,37.0,11873,78,11951,30807,38.79,1,1,35,35,旗山區
1214,2020-06-06 17:23:25,3863,145,30.86,4008,56,4064,12517,32.47,1,1,18,18,內門區
1215,2020-06-06 17:23:25,179,24,5.36,203,2,205,2891,7.09,1,0,8,7,桃源區
1216,2020-06-06 17:23:25,4202,104,35.92,4306,21,4327,10008,43.24,1,0,12,11,永安區
1217,2020-06-06 17:23:25,209,7,8.95,216,0,216,2334,9.25,1,1,4,4,那瑪夏區
1218,2020-06-06 17:23:25,2733,121,26.69,2854,28,2882,10238,28.15,1,1,10,10,杉林區
1219,2020-06-06 17:23:25,14032,404,46.35,14436,87,14523,30272,47.98,1,1,28,28,梓官區
1220,2020-06-06 17:23:25,1223,56,23.41,1279,16,1295,5224,24.79,1,1,7,7,甲仙區
1221,2020-06-06 17:24:16,778143,21118,33.83,799261,4302,803563,1921345,41.82,38,22,1823,1562,高雄市
1222,2020-06-06 17:24:16,9107,221,43.17,9328,57,9385,21094,44.49,1,1,24,24,鹽埕區
1223,2020-06-06 17:24:17,55875,1492,36.88,57367,260,57627,137729,41.84,1,0,99,91,楠梓區
1224,2020-06-06 17:24:17,51954,1320,32.86,53274,241,53515,144469,37.04,1,0,103,96,左營區
1225,2020-06-06 17:24:17,80426,1940,28.59,82366,393,82759,189552,43.66,1,0,189,133,三民區
1226,2020-06-06 17:24:17,29115,676,25.67,29791,127,29918,73656,40.62,1,0,77,55,鼓山區
1227,2020-06-06 17:24:17,17452,443,40.21,17895,96,17991,43397,41.46,1,1,42,42,新興區
1228,2020-06-06 17:24:18,61747,1655,39.26,63402,317,63719,146580,43.47,1,0,119,111,前鎮區
1229,2020-06-06 17:24:18,9437,252,39.81,9689,47,9736,23704,41.07,1,1,22,22,前金區
1230,2020-06-06 17:24:18,51621,1292,36.17,52913,270,53183,129542,41.05,1,0,116,106,苓雅區
1231,2020-06-06 17:24:19,25028,684,43.44,25712,194,25906,57617,44.96,1,1,51,51,林園區
1232,2020-06-06 17:24:19,52396,1349,40.43,53745,245,53990,123170,43.83,1,0,89,85,小港區
1233,2020-06-06 17:24:19,10658,295,44.49,10953,58,11011,23954,45.97,1,1,18,18,旗津區
1234,2020-06-06 17:24:19,66811,1778,22.72,68589,340,68929,174236,39.56,1,0,228,139,鳳山區
1235,2020-06-06 17:24:20,15938,396,40.91,16334,89,16423,37256,44.08,1,0,28,27,鳥松區
1236,2020-06-06 17:24:20,29652,807,40.08,30459,151,30610,66928,45.74,1,0,47,43,仁武區
1237,2020-06-06 17:24:20,14317,465,43.95,14782,79,14861,28427,52.28,1,0,31,27,橋頭區
1238,2020-06-06 17:24:20,15318,389,42.88,15707,89,15796,35719,44.22,1,1,32,32,大樹區
1239,2020-06-06 17:24:20,13320,363,45.49,13683,89,13772,29282,47.03,1,1,24,24,大社區
1240,2020-06-06 17:24:20,20552,506,21.64,21058,124,21182,51678,40.99,1,0,81,45,大寮區
1241,2020-06-06 17:24:20,27105,755,34.26,27860,150,28010,67615,41.43,1,0,72,63,岡山區
1242,2020-06-06 17:24:21,18054,568,42.55,18622,111,18733,42432,44.15,1,1,41,41,路竹區
1243,2020-06-06 17:24:21,4914,122,42.0,5036,23,5059,11699,43.24,1,1,12,12,永安區
1244,2020-06-06 17:24:21,10559,281,44.29,10840,70,10910,23841,45.76,1,1,21,21,阿蓮區
1245,2020-06-06 17:24:21,10600,315,41.54,10915,59,10974,25515,43.01,1,1,21,21,茄萣區
1246,2020-06-06 17:24:21,6173,193,38.78,6366,48,6414,15918,40.29,1,1,18,18,彌陀區
1247,2020-06-06 17:24:21,2552,92,39.72,2644,21,2665,6425,41.48,1,1,12,12,田寮區
1248,2020-06-06 17:24:21,10618,306,41.88,10924,91,11015,25354,43.44,1,1,25,25,燕巢區
1249,2020-06-06 17:24:21,10929,369,43.55,11298,75,11373,25097,45.32,1,1,24,24,湖內區
1250,2020-06-06 17:24:22,9573,411,28.06,9984,86,10070,33458,30.1,1,0,32,31,美濃區
1251,2020-06-06 17:24:22,11399,474,37.0,11873,78,11951,30807,38.79,1,1,35,35,旗山區
1252,2020-06-06 17:24:22,14032,404,46.35,14436,87,14523,30272,47.98,1,1,28,28,梓官區
1253,2020-06-06 17:24:22,2644,151,24.25,2795,35,2830,10198,27.75,1,0,12,11,六龜區
1254,2020-06-06 17:24:23,209,7,8.95,216,0,216,2334,9.25,1,1,4,4,那瑪夏區
1255,2020-06-06 17:24:23,3863,145,30.86,4008,56,4064,12517,32.47,1,1,18,18,內門區
1256,2020-06-06 17:24:23,60,1,3.95,61,0,61,1520,4.01,1,1,3,3,茂林區
1257,2020-06-06 17:24:23,1223,56,23.41,1279,16,1295,5224,24.79,1,1,7,7,甲仙區
1258,2020-06-06 17:24:23,2733,121,26.69,2854,28,2882,10238,28.15,1,1,10,10,杉林區
1259,2020-06-06 17:24:23,179,24,5.36,203,2,205,2891,7.09,1,0,8,7,桃源區
1260,2020-06-06 17:25:14,66811,1778,22.72,68589,340,68929,174236,39.56,1,0,228,139,鳳山區
1261,2020-06-06 17:25:14,29115,676,25.67,29791,127,29918,73656,40.62,1,0,77,55,鼓山區
1262,2020-06-06 17:25:14,9437,252,39.81,9689,47,9736,23704,41.07,1,1,22,22,前金區
1263,2020-06-06 17:25:14,52396,1349,40.43,53745,245,53990,123170,43.83,1,0,89,85,小港區
1264,2020-06-06 17:25:14,55875,1492,36.88,57367,260,57627,137729,41.84,1,0,99,91,楠梓區
1265,2020-06-06 17:25:14,17452,443,40.21,17895,96,17991,43397,41.46,1,1,42,42,新興區
1266,2020-06-06 17:25:14,80426,1940,28.59,82366,393,82759,189552,43.66,1,0,189,133,三民區
1267,2020-06-06 17:25:14,51954,1320,32.86,53274,241,53515,144469,37.04,1,0,103,96,左營區
1268,2020-06-06 17:25:14,9107,221,43.17,9328,57,9385,21094,44.49,1,1,24,24,鹽埕區
1269,2020-06-06 17:25:14,61747,1655,39.26,63402,317,63719,146580,43.47,1,0,119,111,前鎮區
1270,2020-06-06 17:25:14,51621,1292,36.17,52913,270,53183,129542,41.05,1,0,116,106,苓雅區
1271,2020-06-06 17:25:14,10658,295,44.49,10953,58,11011,23954,45.97,1,1,18,18,旗津區
1272,2020-06-06 17:25:14,25028,684,43.44,25712,194,25906,57617,44.96,1,1,51,51,林園區
1273,2020-06-06 17:25:14,778143,21118,33.83,799261,4302,803563,1921345,41.82,38,22,1823,1562,高雄市
1274,2020-06-06 17:25:15,2552,92,39.72,2644,21,2665,6425,41.48,1,1,12,12,田寮區
1275,2020-06-06 17:25:15,20552,506,21.64,21058,124,21182,51678,40.99,1,0,81,45,大寮區
1276,2020-06-06 17:25:15,10600,315,41.54,10915,59,10974,25515,43.01,1,1,21,21,茄萣區
1277,2020-06-06 17:25:15,14317,465,43.95,14782,79,14861,28427,52.28,1,0,31,27,橋頭區
1278,2020-06-06 17:25:15,10618,306,41.88,10924,91,11015,25354,43.44,1,1,25,25,燕巢區
1279,2020-06-06 17:25:15,10559,281,44.29,10840,70,10910,23841,45.76,1,1,21,21,阿蓮區
1280,2020-06-06 17:25:15,15318,389,42.88,15707,89,15796,35719,44.22,1,1,32,32,大樹區
1281,2020-06-06 17:25:15,29652,807,40.08,30459,151,30610,66928,45.74,1,0,47,43,仁武區
1282,2020-06-06 17:25:15,13320,363,45.49,13683,89,13772,29282,47.03,1,1,24,24,大社區
1283,2020-06-06 17:25:15,15938,396,40.91,16334,89,16423,37256,44.08,1,0,28,27,鳥松區
1284,2020-06-06 17:25:15,4914,122,42.0,5036,23,5059,11699,43.24,1,1,12,12,永安區
1285,2020-06-06 17:25:15,27105,755,34.26,27860,150,28010,67615,41.43,1,0,72,63,岡山區
1286,2020-06-06 17:25:15,10929,369,43.55,11298,75,11373,25097,45.32,1,1,24,24,湖內區
1287,2020-06-06 17:25:15,18054,568,42.55,18622,111,18733,42432,44.15,1,1,41,41,路竹區
1288,2020-06-06 17:25:16,3863,145,30.86,4008,56,4064,12517,32.47,1,1,18,18,內門區
1289,2020-06-06 17:25:16,2733,121,26.69,2854,28,2882,10238,28.15,1,1,10,10,杉林區
1290,2020-06-06 17:25:16,209,7,8.95,216,0,216,2334,9.25,1,1,4,4,那瑪夏區
1291,2020-06-06 17:25:16,14032,404,46.35,14436,87,14523,30272,47.98,1,1,28,28,梓官區
1292,2020-06-06 17:25:16,60,1,3.95,61,0,61,1520,4.01,1,1,3,3,茂林區
1293,2020-06-06 17:25:16,9573,411,28.06,9984,86,10070,33458,30.1,1,0,32,31,美濃區
1294,2020-06-06 17:25:16,1223,56,23.41,1279,16,1295,5224,24.79,1,1,7,7,甲仙區
1295,2020-06-06 17:25:16,2644,151,24.25,2795,35,2830,10198,27.75,1,0,12,11,六龜區
1296,2020-06-06 17:25:16,11399,474,37.0,11873,78,11951,30807,38.79,1,1,35,35,旗山區
1297,2020-06-06 17:25:16,179,24,5.36,203,2,205,2891,7.09,1,0,8,7,桃源區
1298,2020-06-06 17:25:16,6173,193,38.78,6366,48,6414,15918,40.29,1,1,18,18,彌陀區
1299,2020-06-06 17:26:07,52396,1349,40.43,53745,245,53990,123170,43.83,1,0,89,85,小港區
1300,2020-06-06 17:26:07,20552,506,21.64,21058,124,21182,51678,40.99,1,0,81,45,大寮區
1301,2020-06-06 17:26:07,80426,1940,28.59,82366,393,82759,189552,43.66,1,0,189,133,三民區
1302,2020-06-06 17:26:07,61747,1655,39.26,63402,317,63719,146580,43.47,1,0,119,111,前鎮區
1303,2020-06-06 17:26:07,10658,295,44.49,10953,58,11011,23954,45.97,1,1,18,18,旗津區
1304,2020-06-06 17:26:07,9107,221,43.17,9328,57,9385,21094,44.49,1,1,24,24,鹽埕區
1305,2020-06-06 17:26:07,9437,252,39.81,9689,47,9736,23704,41.07,1,1,22,22,前金區
1306,2020-06-06 17:26:07,51954,1320,32.86,53274,241,53515,144469,37.04,1,0,103,96,左營區
1307,2020-06-06 17:26:07,66811,1778,22.72,68589,340,68929,174236,39.56,1,0,228,139,鳳山區
1308,2020-06-06 17:26:07,17452,443,40.21,17895,96,17991,43397,41.46,1,1,42,42,新興區
1309,2020-06-06 17:26:07,29115,676,25.67,29791,127,29918,73656,40.62,1,0,77,55,鼓山區
1310,2020-06-06 17:26:07,778143,21118,33.83,799261,4302,803563,1921345,41.82,38,22,1823,1562,高雄市
1311,2020-06-06 17:26:07,51621,1292,36.17,52913,270,53183,129542,41.05,1,0,116,106,苓雅區
1312,2020-06-06 17:26:07,25028,684,43.44,25712,194,25906,57617,44.96,1,1,51,51,林園區
1313,2020-06-06 17:26:07,55875,1492,36.88,57367,260,57627,137729,41.84,1,0,99,91,楠梓區
1314,2020-06-06 17:26:08,14317,465,43.95,14782,79,14861,28427,52.28,1,0,31,27,橋頭區
1315,2020-06-06 17:26:08,6173,193,38.78,6366,48,6414,15918,40.29,1,1,18,18,彌陀區
1316,2020-06-06 17:26:08,10929,369,43.55,11298,75,11373,25097,45.32,1,1,24,24,湖內區
1317,2020-06-06 17:26:08,18054,568,42.55,18622,111,18733,42432,44.15,1,1,41,41,路竹區
1318,2020-06-06 17:26:08,10559,281,44.29,10840,70,10910,23841,45.76,1,1,21,21,阿蓮區
1319,2020-06-06 17:26:08,15938,396,40.91,16334,89,16423,37256,44.08,1,0,28,27,鳥松區
1320,2020-06-06 17:26:08,15318,389,42.88,15707,89,15796,35719,44.22,1,1,32,32,大樹區
1321,2020-06-06 17:26:08,29652,807,40.08,30459,151,30610,66928,45.74,1,0,47,43,仁武區
1322,2020-06-06 17:26:08,4914,122,42.0,5036,23,5059,11699,43.24,1,1,12,12,永安區
1323,2020-06-06 17:26:08,2552,92,39.72,2644,21,2665,6425,41.48,1,1,12,12,田寮區
1324,2020-06-06 17:26:08,13320,363,45.49,13683,89,13772,29282,47.03,1,1,24,24,大社區
1325,2020-06-06 17:26:08,10600,315,41.54,10915,59,10974,25515,43.01,1,1,21,21,茄萣區
1326,2020-06-06 17:26:08,27105,755,34.26,27860,150,28010,67615,41.43,1,0,72,63,岡山區
1327,2020-06-06 17:26:08,10618,306,41.88,10924,91,11015,25354,43.44,1,1,25,25,燕巢區
1328,2020-06-06 17:26:09,14032,404,46.35,14436,87,14523,30272,47.98,1,1,28,28,梓官區
1329,2020-06-06 17:26:09,9573,411,28.06,9984,86,10070,33458,30.1,1,0,32,31,美濃區
1330,2020-06-06 17:26:09,2644,151,24.25,2795,35,2830,10198,27.75,1,0,12,11,六龜區
1331,2020-06-06 17:26:09,11399,474,37.0,11873,78,11951,30807,38.79,1,1,35,35,旗山區
1332,2020-06-06 17:26:10,3863,145,30.86,4008,56,4064,12517,32.47,1,1,18,18,內門區
1333,2020-06-06 17:26:10,179,24,5.36,203,2,205,2891,7.09,1,0,8,7,桃源區
1334,2020-06-06 17:26:10,60,1,3.95,61,0,61,1520,4.01,1,1,3,3,茂林區
1335,2020-06-06 17:26:10,2733,121,26.69,2854,28,2882,10238,28.15,1,1,10,10,杉林區
1336,2020-06-06 17:26:10,209,7,8.95,216,0,216,2334,9.25,1,1,4,4,那瑪夏區
1337,2020-06-06 17:26:10,1223,56,23.41,1279,16,1295,5224,24.79,1,1,7,7,甲仙區
1338,2020-06-06 17:27:00,9107,221,43.17,9328,57,9385,21094,44.49,1,1,24,24,鹽埕區
1339,2020-06-06 17:27:00,778143,21118,33.83,799261,4302,803563,1921345,41.82,38,22,1823,1562,高雄市
1340,2020-06-06 17:27:00,51954,1320,32.86,53274,241,53515,144469,37.04,1,0,103,96,左營區
1341,2020-06-06 17:27:00,29115,676,25.67,29791,127,29918,73656,40.62,1,0,77,55,鼓山區
1342,2020-06-06 17:27:00,55875,1492,36.88,57367,260,57627,137729,41.84,1,0,99,91,楠梓區
1343,2020-06-06 17:27:00,80426,1940,28.59,82366,393,82759,189552,43.66,1,0,189,133,三民區
1344,2020-06-06 17:27:01,29652,807,40.08,30459,151,30610,66928,45.74,1,0,47,43,仁武區
1345,2020-06-06 17:27:01,27105,755,34.26,27860,150,28010,67615,41.43,1,0,72,63,岡山區
1346,2020-06-06 17:27:01,10658,295,44.49,10953,58,11011,23954,45.97,1,1,18,18,旗津區
1347,2020-06-06 17:27:01,9437,252,39.81,9689,47,9736,23704,41.07,1,1,22,22,前金區
1348,2020-06-06 17:27:01,15318,389,42.88,15707,89,15796,35719,44.22,1,1,32,32,大樹區
1349,2020-06-06 17:27:01,61747,1655,39.26,63402,317,63719,146580,43.47,1,0,119,111,前鎮區
1350,2020-06-06 17:27:01,66811,1778,22.72,68589,340,68929,174236,39.56,1,0,228,139,鳳山區
1351,2020-06-06 17:27:01,13320,363,45.49,13683,89,13772,29282,47.03,1,1,24,24,大社區
1352,2020-06-06 17:27:01,25028,684,43.44,25712,194,25906,57617,44.96,1,1,51,51,林園區
1353,2020-06-06 17:27:01,17452,443,40.21,17895,96,17991,43397,41.46,1,1,42,42,新興區
1354,2020-06-06 17:27:01,2552,92,39.72,2644,21,2665,6425,41.48,1,1,12,12,田寮區
1355,2020-06-06 17:27:01,20552,506,21.64,21058,124,21182,51678,40.99,1,0,81,45,大寮區
1356,2020-06-06 17:27:01,15938,396,40.91,16334,89,16423,37256,44.08,1,0,28,27,鳥松區
1357,2020-06-06 17:27:01,14317,465,43.95,14782,79,14861,28427,52.28,1,0,31,27,橋頭區
1358,2020-06-06 17:27:01,10618,306,41.88,10924,91,11015,25354,43.44,1,1,25,25,燕巢區
1359,2020-06-06 17:27:01,52396,1349,40.43,53745,245,53990,123170,43.83,1,0,89,85,小港區
1360,2020-06-06 17:27:01,51621,1292,36.17,52913,270,53183,129542,41.05,1,0,116,106,苓雅區
1361,2020-06-06 17:27:02,18054,568,42.55,18622,111,18733,42432,44.15,1,1,41,41,路竹區
1362,2020-06-06 17:27:02,3863,145,30.86,4008,56,4064,12517,32.47,1,1,18,18,內門區
1363,2020-06-06 17:27:02,9573,411,28.06,9984,86,10070,33458,30.1,1,0,32,31,美濃區
1364,2020-06-06 17:27:02,10600,315,41.54,10915,59,10974,25515,43.01,1,1,21,21,茄萣區
1365,2020-06-06 17:27:02,2733,121,26.69,2854,28,2882,10238,28.15,1,1,10,10,杉林區
1366,2020-06-06 17:27:02,1223,56,23.41,1279,16,1295,5224,24.79,1,1,7,7,甲仙區
1367,2020-06-06 17:27:02,14032,404,46.35,14436,87,14523,30272,47.98,1,1,28,28,梓官區
1368,2020-06-06 17:27:02,60,1,3.95,61,0,61,1520,4.01,1,1,3,3,茂林區
1369,2020-06-06 17:27:02,10559,281,44.29,10840,70,10910,23841,45.76,1,1,21,21,阿蓮區
1370,2020-06-06 17:27:02,6173,193,38.78,6366,48,6414,15918,40.29,1,1,18,18,彌陀區
1371,2020-06-06 17:27:02,2644,151,24.25,2795,35,2830,10198,27.75,1,0,12,11,六龜區
1372,2020-06-06 17:27:02,4914,122,42.0,5036,23,5059,11699,43.24,1,1,12,12,永安區
1373,2020-06-06 17:27:02,10929,369,43.55,11298,75,11373,25097,45.32,1,1,24,24,湖內區
1374,2020-06-06 17:27:02,11399,474,37.0,11873,78,11951,30807,38.79,1,1,35,35,旗山區
1375,2020-06-06 17:27:02,179,24,5.36,203,2,205,2891,7.09,1,0,8,7,桃源區
1376,2020-06-06 17:27:03,209,7,8.95,216,0,216,2334,9.25,1,1,4,4,那瑪夏區
1377,2020-06-06 17:27:53,52918,1316,37.07,54234,276,54510,132763,41.06,1,0,116,108,苓雅區
1378,2020-06-06 17:27:53,55875,1492,36.88,57367,260,57627,137729,41.84,1,0,99,91,楠梓區
1379,2020-06-06 17:27:53,803257,21730,34.92,824987,4449,829436,1980843,41.87,38,23,1823,1605,高雄市
1380,2020-06-06 17:27:53,22526,570,23.71,23096,134,23230,56471,41.14,1,0,81,49,大寮區
1381,2020-06-06 17:27:53,88600,2132,31.5,90732,434,91166,208657,43.69,1,0,189,145,三民區
1382,2020-06-06 17:27:53,51954,1320,32.86,53274,241,53515,144469,37.04,1,0,103,96,左營區
1383,2020-06-06 17:27:53,25028,684,43.44,25712,194,25906,57617,44.96,1,1,51,51,林園區
1384,2020-06-06 17:27:53,17452,443,40.21,17895,96,17991,43397,41.46,1,1,42,42,新興區
1385,2020-06-06 17:27:53,9437,252,39.81,9689,47,9736,23704,41.07,1,1,22,22,前金區
1386,2020-06-06 17:27:53,10658,295,44.49,10953,58,11011,23954,45.97,1,1,18,18,旗津區
1387,2020-06-06 17:27:53,9107,221,43.17,9328,57,9385,21094,44.49,1,1,24,24,鹽埕區
1388,2020-06-06 17:27:53,64330,1717,40.9,66047,332,66379,151992,43.67,1,0,119,115,前鎮區
1389,2020-06-06 17:27:53,52396,1349,40.43,53745,245,53990,123170,43.83,1,0,89,85,小港區
1390,2020-06-06 17:27:53,31337,724,27.63,32061,138,32199,79471,40.52,1,0,77,58,鼓山區
1391,2020-06-06 17:27:53,72553,1925,24.67,74478,380,74858,187575,39.91,1,0,228,150,鳳山區
1392,2020-06-06 17:27:54,15318,389,42.88,15707,89,15796,35719,44.22,1,1,32,32,大樹區
1393,2020-06-06 17:27:54,31012,847,41.92,31859,160,32019,70182,45.62,1,0,47,45,仁武區
1394,2020-06-06 17:27:54,15938,396,40.91,16334,89,16423,37256,44.08,1,0,28,27,鳥松區
1395,2020-06-06 17:27:54,13320,363,45.49,13683,89,13772,29282,47.03,1,1,24,24,大社區
1396,2020-06-06 17:27:55,14900,471,45.74,15371,81,15452,29618,52.17,1,0,31,28,橋頭區
1397,2020-06-06 17:27:55,28262,784,35.72,29046,163,29209,70532,41.41,1,0,72,66,岡山區
1398,2020-06-06 17:27:55,10618,306,41.88,10924,91,11015,25354,43.44,1,1,25,25,燕巢區
1399,2020-06-06 17:27:55,2552,92,39.72,2644,21,2665,6425,41.48,1,1,12,12,田寮區
1400,2020-06-06 17:27:56,18054,568,42.55,18622,111,18733,42432,44.15,1,1,41,41,路竹區
1401,2020-06-06 17:27:56,4914,122,42.0,5036,23,5059,11699,43.24,1,1,12,12,永安區
1402,2020-06-06 17:27:56,10929,369,43.55,11298,75,11373,25097,45.32,1,1,24,24,湖內區
1403,2020-06-06 17:27:56,10600,315,41.54,10915,59,10974,25515,43.01,1,1,21,21,茄萣區
1404,2020-06-06 17:27:56,6173,193,38.78,6366,48,6414,15918,40.29,1,1,18,18,彌陀區
1405,2020-06-06 17:27:56,10559,281,44.29,10840,70,10910,23841,45.76,1,1,21,21,阿蓮區
1406,2020-06-06 17:27:57,11399,474,37.0,11873,78,11951,30807,38.79,1,1,35,35,旗山區
1407,2020-06-06 17:27:57,14032,404,46.35,14436,87,14523,30272,47.98,1,1,28,28,梓官區
1408,2020-06-06 17:27:58,9573,411,28.06,9984,86,10070,33458,30.1,1,0,32,31,美濃區
1409,2020-06-06 17:27:58,2644,151,24.25,2795,35,2830,10198,27.75,1,0,12,11,六龜區
1410,2020-06-06 17:27:58,1223,56,23.41,1279,16,1295,5224,24.79,1,1,7,7,甲仙區
1411,2020-06-06 17:27:58,2733,121,26.69,2854,28,2882,10238,28.15,1,1,10,10,杉林區
1412,2020-06-06 17:27:58,3863,145,30.86,4008,56,4064,12517,32.47,1,1,18,18,內門區
1413,2020-06-06 17:27:58,209,7,8.95,216,0,216,2334,9.25,1,1,4,4,那瑪夏區
1414,2020-06-06 17:27:58,60,1,3.95,61,0,61,1520,4.01,1,1,3,3,茂林區
1415,2020-06-06 17:27:58,201,24,6.01,225,2,227,3342,6.79,1,1,8,8,桃源區
1416,2020-06-06 17:28:48,803257,21730,34.92,824987,4449,829436,1980843,41.87,38,23,1823,1605,高雄市
1417,2020-06-06 17:28:49,9107,221,43.17,9328,57,9385,21094,44.49,1,1,24,24,鹽埕區
1418,2020-06-06 17:28:49,25028,684,43.44,25712,194,25906,57617,44.96,1,1,51,51,林園區
1419,2020-06-06 17:28:49,51954,1320,32.86,53274,241,53515,144469,37.04,1,0,103,96,左營區
1420,2020-06-06 17:28:49,52396,1349,40.43,53745,245,53990,123170,43.83,1,0,89,85,小港區
1421,2020-06-06 17:28:49,31012,847,41.92,31859,160,32019,70182,45.62,1,0,47,45,仁武區
1422,2020-06-06 17:28:49,72553,1925,24.67,74478,380,74858,187575,39.91,1,0,228,150,鳳山區
1423,2020-06-06 17:28:49,10658,295,44.49,10953,58,11011,23954,45.97,1,1,18,18,旗津區
1424,2020-06-06 17:28:49,52918,1316,37.07,54234,276,54510,132763,41.06,1,0,116,108,苓雅區
1425,2020-06-06 17:28:49,22526,570,23.71,23096,134,23230,56471,41.14,1,0,81,49,大寮區
1426,2020-06-06 17:28:49,64330,1717,40.9,66047,332,66379,151992,43.67,1,0,119,115,前鎮區
1427,2020-06-06 17:28:49,13320,363,45.49,13683,89,13772,29282,47.03,1,1,24,24,大社區
1428,2020-06-06 17:28:49,9437,252,39.81,9689,47,9736,23704,41.07,1,1,22,22,前金區
1429,2020-06-06 17:28:49,55875,1492,36.88,57367,260,57627,137729,41.84,1,0,99,91,楠梓區
1430,2020-06-06 17:28:49,17452,443,40.21,17895,96,17991,43397,41.46,1,1,42,42,新興區
1431,2020-06-06 17:28:49,15318,389,42.88,15707,89,15796,35719,44.22,1,1,32,32,大樹區
1432,2020-06-06 17:28:49,31337,724,27.63,32061,138,32199,79471,40.52,1,0,77,58,鼓山區
1433,2020-06-06 17:28:49,88600,2132,31.5,90732,434,91166,208657,43.69,1,0,189,145,三民區
1434,2020-06-06 17:28:50,11399,474,37.0,11873,78,11951,30807,38.79,1,1,35,35,旗山區
1435,2020-06-06 17:28:50,14900,471,45.74,15371,81,15452,29618,52.17,1,0,31,28,橋頭區
1436,2020-06-06 17:28:50,18054,568,42.55,18622,111,18733,42432,44.15,1,1,41,41,路竹區
1437,2020-06-06 17:28:50,15938,396,40.91,16334,89,16423,37256,44.08,1,0,28,27,鳥松區
1438,2020-06-06 17:28:50,4914,122,42.0,5036,23,5059,11699,43.24,1,1,12,12,永安區
1439,2020-06-06 17:28:50,10618,306,41.88,10924,91,11015,25354,43.44,1,1,25,25,燕巢區
1440,2020-06-06 17:28:50,10929,369,43.55,11298,75,11373,25097,45.32,1,1,24,24,湖內區
1441,2020-06-06 17:28:50,10559,281,44.29,10840,70,10910,23841,45.76,1,1,21,21,阿蓮區
1442,2020-06-06 17:28:50,6173,193,38.78,6366,48,6414,15918,40.29,1,1,18,18,彌陀區
1443,2020-06-06 17:28:50,9573,411,28.06,9984,86,10070,33458,30.1,1,0,32,31,美濃區
1444,2020-06-06 17:28:50,28262,784,35.72,29046,163,29209,70532,41.41,1,0,72,66,岡山區
1445,2020-06-06 17:28:50,10600,315,41.54,10915,59,10974,25515,43.01,1,1,21,21,茄萣區
1446,2020-06-06 17:28:50,2552,92,39.72,2644,21,2665,6425,41.48,1,1,12,12,田寮區
1447,2020-06-06 17:28:50,14032,404,46.35,14436,87,14523,30272,47.98,1,1,28,28,梓官區
1448,2020-06-06 17:28:51,1223,56,23.41,1279,16,1295,5224,24.79,1,1,7,7,甲仙區
1449,2020-06-06 17:28:51,2733,121,26.69,2854,28,2882,10238,28.15,1,1,10,10,杉林區
1450,2020-06-06 17:28:51,209,7,8.95,216,0,216,2334,9.25,1,1,4,4,那瑪夏區
1451,2020-06-06 17:28:51,2644,151,24.25,2795,35,2830,10198,27.75,1,0,12,11,六龜區
1452,2020-06-06 17:28:51,201,24,6.01,225,2,227,3342,6.79,1,1,8,8,桃源區
1453,2020-06-06 17:28:51,3863,145,30.86,4008,56,4064,12517,32.47,1,1,18,18,內門區
1454,2020-06-06 17:28:51,60,1,3.95,61,0,61,1520,4.01,1,1,3,3,茂林區
1455,2020-06-06 17:29:41,9107,221,43.17,9328,57,9385,21094,44.49,1,1,24,24,鹽埕區
1456,2020-06-06 17:29:41,803257,21730,34.92,824987,4449,829436,1980843,41.87,38,23,1823,1605,高雄市
1457,2020-06-06 17:29:42,31337,724,27.63,32061,138,32199,79471,40.52,1,0,77,58,鼓山區
1458,2020-06-06 17:29:42,51954,1320,32.86,53274,241,53515,144469,37.04,1,0,103,96,左營區
1459,2020-06-06 17:29:42,55875,1492,36.88,57367,260,57627,137729,41.84,1,0,99,91,楠梓區
1460,2020-06-06 17:29:43,88600,2132,31.5,90732,434,91166,208657,43.69,1,0,189,145,三民區
1461,2020-06-06 17:29:43,17452,443,40.21,17895,96,17991,43397,41.46,1,1,42,42,新興區
1462,2020-06-06 17:29:43,9437,252,39.81,9689,47,9736,23704,41.07,1,1,22,22,前金區
1463,2020-06-06 17:29:44,52396,1349,40.43,53745,245,53990,123170,43.83,1,0,89,85,小港區
1464,2020-06-06 17:29:44,64330,1717,40.9,66047,332,66379,151992,43.67,1,0,119,115,前鎮區
1465,2020-06-06 17:29:44,52918,1316,37.07,54234,276,54510,132763,41.06,1,0,116,108,苓雅區
1466,2020-06-06 17:29:44,72553,1925,24.67,74478,380,74858,187575,39.91,1,0,228,150,鳳山區
1467,2020-06-06 17:29:44,10658,295,44.49,10953,58,11011,23954,45.97,1,1,18,18,旗津區
1468,2020-06-06 17:29:45,2552,92,39.72,2644,21,2665,6425,41.48,1,1,12,12,田寮區
1469,2020-06-06 17:29:45,14900,471,45.74,15371,81,15452,29618,52.17,1,0,31,28,橋頭區
1470,2020-06-06 17:29:45,15938,396,40.91,16334,89,16423,37256,44.08,1,0,28,27,鳥松區
1471,2020-06-06 17:29:45,31012,847,41.92,31859,160,32019,70182,45.62,1,0,47,45,仁武區
1472,2020-06-06 17:29:45,25028,684,43.44,25712,194,25906,57617,44.96,1,1,51,51,林園區
1473,2020-06-06 17:29:45,10559,281,44.29,10840,70,10910,23841,45.76,1,1,21,21,阿蓮區
1474,2020-06-06 17:29:45,28262,784,35.72,29046,163,29209,70532,41.41,1,0,72,66,岡山區
1475,2020-06-06 17:29:45,13320,363,45.49,13683,89,13772,29282,47.03,1,1,24,24,大社區
1476,2020-06-06 17:29:45,10618,306,41.88,10924,91,11015,25354,43.44,1,1,25,25,燕巢區
1477,2020-06-06 17:29:45,15318,389,42.88,15707,89,15796,35719,44.22,1,1,32,32,大樹區
1478,2020-06-06 17:29:45,22526,570,23.71,23096,134,23230,56471,41.14,1,0,81,49,大寮區
1479,2020-06-06 17:29:46,1223,56,23.41,1279,16,1295,5224,24.79,1,1,7,7,甲仙區
1480,2020-06-06 17:29:46,18054,568,42.55,18622,111,18733,42432,44.15,1,1,41,41,路竹區
1481,2020-06-06 17:29:46,14032,404,46.35,14436,87,14523,30272,47.98,1,1,28,28,梓官區
1482,2020-06-06 17:29:46,11399,474,37.0,11873,78,11951,30807,38.79,1,1,35,35,旗山區
1483,2020-06-06 17:29:46,60,1,3.95,61,0,61,1520,4.01,1,1,3,3,茂林區
1484,2020-06-06 17:29:46,2644,151,24.25,2795,35,2830,10198,27.75,1,0,12,11,六龜區
1485,2020-06-06 17:29:46,4914,122,42.0,5036,23,5059,11699,43.24,1,1,12,12,永安區
1486,2020-06-06 17:29:46,3863,145,30.86,4008,56,4064,12517,32.47,1,1,18,18,內門區
1487,2020-06-06 17:29:46,2733,121,26.69,2854,28,2882,10238,28.15,1,1,10,10,杉林區
1488,2020-06-06 17:29:46,9573,411,28.06,9984,86,10070,33458,30.1,1,0,32,31,美濃區
1489,2020-06-06 17:29:46,10600,315,41.54,10915,59,10974,25515,43.01,1,1,21,21,茄萣區
1490,2020-06-06 17:29:46,6173,193,38.78,6366,48,6414,15918,40.29,1,1,18,18,彌陀區
1491,2020-06-06 17:29:46,10929,369,43.55,11298,75,11373,25097,45.32,1,1,24,24,湖內區
1492,2020-06-06 17:29:47,201,24,6.01,225,2,227,3342,6.79,1,1,8,8,桃源區
1493,2020-06-06 17:29:47,209,7,8.95,216,0,216,2334,9.25,1,1,4,4,那瑪夏區
1494,2020-06-06 17:30:37,9437,252,39.81,9689,47,9736,23704,41.07,1,1,22,22,前金區
1495,2020-06-06 17:30:37,10658,295,44.49,10953,58,11011,23954,45.97,1,1,18,18,旗津區
1496,2020-06-06 17:30:37,831876,22387,36.17,854263,4600,858863,2048683,41.92,38,24,1823,1651,高雄市
1497,2020-06-06 17:30:37,66442,1768,42.24,68210,345,68555,156595,43.78,1,0,119,118,前鎮區
1498,2020-06-06 17:30:37,54032,1342,37.86,55374,279,55653,135638,41.03,1,0,116,110,苓雅區
1499,2020-06-06 17:30:37,17452,443,40.21,17895,96,17991,43397,41.46,1,1,42,42,新興區
1500,2020-06-06 17:30:37,57154,1516,37.72,58670,270,58940,140723,41.88,1,0,99,93,楠梓區
1501,2020-06-06 17:30:37,53688,1378,41.43,55066,251,55317,126124,43.86,1,0,89,87,小港區
1502,2020-06-06 17:30:37,54483,1356,34.46,55839,258,56097,150491,37.28,1,0,103,99,左營區
1503,2020-06-06 17:30:37,94039,2263,33.43,96302,461,96763,221292,43.73,1,0,189,153,三民區
1504,2020-06-06 17:30:37,9107,221,43.17,9328,57,9385,21094,44.49,1,1,24,24,鹽埕區
1505,2020-06-06 17:30:37,35002,791,30.86,35793,147,35940,88507,40.61,1,0,77,63,鼓山區
1506,2020-06-06 17:30:38,2552,92,39.72,2644,21,2665,6425,41.48,1,1,12,12,田寮區
1507,2020-06-06 17:30:38,24387,625,25.67,25012,142,25154,60821,41.36,1,0,81,53,大寮區
1508,2020-06-06 17:30:38,15763,497,48.39,16260,88,16348,31515,51.87,1,0,31,30,橋頭區
1509,2020-06-06 17:30:38,28761,800,36.35,29561,167,29728,71789,41.41,1,0,72,67,岡山區
1510,2020-06-06 17:30:38,18054,568,42.55,18622,111,18733,42432,44.15,1,1,41,41,路竹區
1511,2020-06-06 17:30:38,25028,684,43.44,25712,194,25906,57617,44.96,1,1,51,51,林園區
1512,2020-06-06 17:30:38,10559,281,44.29,10840,70,10910,23841,45.76,1,1,21,21,阿蓮區
1513,2020-06-06 17:30:38,10600,315,41.54,10915,59,10974,25515,43.01,1,1,21,21,茄萣區
1514,2020-06-06 17:30:38,78844,2083,26.81,80927,420,81347,203077,40.06,1,0,228,162,鳳山區
1515,2020-06-06 17:30:38,10929,369,43.55,11298,75,11373,25097,45.32,1,1,24,24,湖內區
1516,2020-06-06 17:30:38,10618,306,41.88,10924,91,11015,25354,43.44,1,1,25,25,燕巢區
1517,2020-06-06 17:30:38,31963,869,43.21,32832,165,32997,72190,45.71,1,0,47,46,仁武區
1518,2020-06-06 17:30:38,16662,412,42.76,17074,91,17165,38963,44.05,1,1,28,28,鳥松區
1519,2020-06-06 17:30:38,15318,389,42.88,15707,89,15796,35719,44.22,1,1,32,32,大樹區
1520,2020-06-06 17:30:38,13320,363,45.49,13683,89,13772,29282,47.03,1,1,24,24,大社區
1521,2020-06-06 17:30:39,14032,404,46.35,14436,87,14523,30272,47.98,1,1,28,28,梓官區
1522,2020-06-06 17:30:39,2644,151,24.25,2795,35,2830,10198,27.75,1,0,12,11,六龜區
1523,2020-06-06 17:30:39,1223,56,23.41,1279,16,1295,5224,24.79,1,1,7,7,甲仙區
1524,2020-06-06 17:30:39,11399,474,37.0,11873,78,11951,30807,38.79,1,1,35,35,旗山區
1525,2020-06-06 17:30:39,4914,122,42.0,5036,23,5059,11699,43.24,1,1,12,12,永安區
1526,2020-06-06 17:30:39,9573,411,28.06,9984,86,10070,33458,30.1,1,0,32,31,美濃區
1527,2020-06-06 17:30:39,6173,193,38.78,6366,48,6414,15918,40.29,1,1,18,18,彌陀區
1528,2020-06-06 17:30:39,2733,121,26.69,2854,28,2882,10238,28.15,1,1,10,10,杉林區
1529,2020-06-06 17:30:40,60,1,3.95,61,0,61,1520,4.01,1,1,3,3,茂林區
1530,2020-06-06 17:30:40,3863,145,30.86,4008,56,4064,12517,32.47,1,1,18,18,內門區
1531,2020-06-06 17:30:40,209,7,8.95,216,0,216,2334,9.25,1,1,4,4,那瑪夏區
1532,2020-06-06 17:30:40,201,24,6.01,225,2,227,3342,6.79,1,1,8,8,桃源區
1533,2020-06-06 17:31:30,831876,22387,36.17,854263,4600,858863,2048683,41.92,38,24,1823,1651,高雄市
1534,2020-06-06 17:31:30,54483,1356,34.46,55839,258,56097,150491,37.28,1,0,103,99,左營區
1535,2020-06-06 17:31:30,35002,791,30.86,35793,147,35940,88507,40.61,1,0,77,63,鼓山區
1536,2020-06-06 17:31:30,9107,221,43.17,9328,57,9385,21094,44.49,1,1,24,24,鹽埕區
1537,2020-06-06 17:31:31,78844,2083,26.81,80927,420,81347,203077,40.06,1,0,228,162,鳳山區
1538,2020-06-06 17:31:31,54032,1342,37.86,55374,279,55653,135638,41.03,1,0,116,110,苓雅區
1539,2020-06-06 17:31:31,24387,625,25.67,25012,142,25154,60821,41.36,1,0,81,53,大寮區
1540,2020-06-06 17:31:31,53688,1378,41.43,55066,251,55317,126124,43.86,1,0,89,87,小港區
1541,2020-06-06 17:31:31,10658,295,44.49,10953,58,11011,23954,45.97,1,1,18,18,旗津區
1542,2020-06-06 17:31:31,25028,684,43.44,25712,194,25906,57617,44.96,1,1,51,51,林園區
1543,2020-06-06 17:31:31,57154,1516,37.72,58670,270,58940,140723,41.88,1,0,99,93,楠梓區
1544,2020-06-06 17:31:31,94039,2263,33.43,96302,461,96763,221292,43.73,1,0,189,153,三民區
1545,2020-06-06 17:31:31,17452,443,40.21,17895,96,17991,43397,41.46,1,1,42,42,新興區
1546,2020-06-06 17:31:31,9437,252,39.81,9689,47,9736,23704,41.07,1,1,22,22,前金區
1547,2020-06-06 17:31:31,66442,1768,42.24,68210,345,68555,156595,43.78,1,0,119,118,前鎮區
1548,2020-06-06 17:31:32,10618,306,41.88,10924,91,11015,25354,43.44,1,1,25,25,燕巢區
1549,2020-06-06 17:31:32,15318,389,42.88,15707,89,15796,35719,44.22,1,1,32,32,大樹區
1550,2020-06-06 17:31:32,10559,281,44.29,10840,70,10910,23841,45.76,1,1,21,21,阿蓮區
1551,2020-06-06 17:31:32,16662,412,42.76,17074,91,17165,38963,44.05,1,1,28,28,鳥松區
1552,2020-06-06 17:31:32,15763,497,48.39,16260,88,16348,31515,51.87,1,0,31,30,橋頭區
1553,2020-06-06 17:31:32,28761,800,36.35,29561,167,29728,71789,41.41,1,0,72,67,岡山區
1554,2020-06-06 17:31:32,2552,92,39.72,2644,21,2665,6425,41.48,1,1,12,12,田寮區
1555,2020-06-06 17:31:32,31963,869,43.21,32832,165,32997,72190,45.71,1,0,47,46,仁武區
1556,2020-06-06 17:31:32,13320,363,45.49,13683,89,13772,29282,47.03,1,1,24,24,大社區
1557,2020-06-06 17:31:33,18054,568,42.55,18622,111,18733,42432,44.15,1,1,41,41,路竹區
1558,2020-06-06 17:31:33,10929,369,43.55,11298,75,11373,25097,45.32,1,1,24,24,湖內區
1559,2020-06-06 17:31:33,4914,122,42.0,5036,23,5059,11699,43.24,1,1,12,12,永安區
1560,2020-06-06 17:31:33,10600,315,41.54,10915,59,10974,25515,43.01,1,1,21,21,茄萣區
1561,2020-06-06 17:31:34,11399,474,37.0,11873,78,11951,30807,38.79,1,1,35,35,旗山區
1562,2020-06-06 17:31:34,1223,56,23.41,1279,16,1295,5224,24.79,1,1,7,7,甲仙區
1563,2020-06-06 17:31:34,60,1,3.95,61,0,61,1520,4.01,1,1,3,3,茂林區
1564,2020-06-06 17:31:34,2733,121,26.69,2854,28,2882,10238,28.15,1,1,10,10,杉林區
1565,2020-06-06 17:31:34,6173,193,38.78,6366,48,6414,15918,40.29,1,1,18,18,彌陀區
1566,2020-06-06 17:31:34,3863,145,30.86,4008,56,4064,12517,32.47,1,1,18,18,內門區
1567,2020-06-06 17:31:34,2644,151,24.25,2795,35,2830,10198,27.75,1,0,12,11,六龜區
1568,2020-06-06 17:31:34,14032,404,46.35,14436,87,14523,30272,47.98,1,1,28,28,梓官區
1569,2020-06-06 17:31:34,201,24,6.01,225,2,227,3342,6.79,1,1,8,8,桃源區
1570,2020-06-06 17:31:34,9573,411,28.06,9984,86,10070,33458,30.1,1,0,32,31,美濃區
1571,2020-06-06 17:31:35,209,7,8.95,216,0,216,2334,9.25,1,1,4,4,那瑪夏區
1572,2020-06-06 17:32:25,54483,1356,34.46,55839,258,56097,150491,37.28,1,0,103,99,左營區
1573,2020-06-06 17:32:25,57154,1516,37.72,58670,270,58940,140723,41.88,1,0,99,93,楠梓區
1574,2020-06-06 17:32:25,831876,22387,36.17,854263,4600,858863,2048683,41.92,38,24,1823,1651,高雄市
1575,2020-06-06 17:32:25,9107,221,43.17,9328,57,9385,21094,44.49,1,1,24,24,鹽埕區
1576,2020-06-06 17:32:25,35002,791,30.86,35793,147,35940,88507,40.61,1,0,77,63,鼓山區
1577,2020-06-06 17:32:26,10658,295,44.49,10953,58,11011,23954,45.97,1,1,18,18,旗津區
1578,2020-06-06 17:32:26,25028,684,43.44,25712,194,25906,57617,44.96,1,1,51,51,林園區
1579,2020-06-06 17:32:26,16662,412,42.76,17074,91,17165,38963,44.05,1,1,28,28,鳥松區
1580,2020-06-06 17:32:26,15318,389,42.88,15707,89,15796,35719,44.22,1,1,32,32,大樹區
1581,2020-06-06 17:32:26,17452,443,40.21,17895,96,17991,43397,41.46,1,1,42,42,新興區
1582,2020-06-06 17:32:26,78844,2083,26.81,80927,420,81347,203077,40.06,1,0,228,162,鳳山區
1583,2020-06-06 17:32:26,54032,1342,37.86,55374,279,55653,135638,41.03,1,0,116,110,苓雅區
1584,2020-06-06 17:32:26,9437,252,39.81,9689,47,9736,23704,41.07,1,1,22,22,前金區
1585,2020-06-06 17:32:26,94039,2263,33.43,96302,461,96763,221292,43.73,1,0,189,153,三民區
1586,2020-06-06 17:32:26,24387,625,25.67,25012,142,25154,60821,41.36,1,0,81,53,大寮區
1587,2020-06-06 17:32:26,53688,1378,41.43,55066,251,55317,126124,43.86,1,0,89,87,小港區
1588,2020-06-06 17:32:26,31963,869,43.21,32832,165,32997,72190,45.71,1,0,47,46,仁武區
1589,2020-06-06 17:32:26,66442,1768,42.24,68210,345,68555,156595,43.78,1,0,119,118,前鎮區
1590,2020-06-06 17:32:26,28761,800,36.35,29561,167,29728,71789,41.41,1,0,72,67,岡山區
1591,2020-06-06 17:32:26,13320,363,45.49,13683,89,13772,29282,47.03,1,1,24,24,大社區
1592,2020-06-06 17:32:27,10618,306,41.88,10924,91,11015,25354,43.44,1,1,25,25,燕巢區
1593,2020-06-06 17:32:27,10600,315,41.54,10915,59,10974,25515,43.01,1,1,21,21,茄萣區
1594,2020-06-06 17:32:27,15763,497,48.39,16260,88,16348,31515,51.87,1,0,31,30,橋頭區
1595,2020-06-06 17:32:27,18054,568,42.55,18622,111,18733,42432,44.15,1,1,41,41,路竹區
1596,2020-06-06 17:32:27,6173,193,38.78,6366,48,6414,15918,40.29,1,1,18,18,彌陀區
1597,2020-06-06 17:32:27,2552,92,39.72,2644,21,2665,6425,41.48,1,1,12,12,田寮區
1598,2020-06-06 17:32:27,14032,404,46.35,14436,87,14523,30272,47.98,1,1,28,28,梓官區
1599,2020-06-06 17:32:27,10929,369,43.55,11298,75,11373,25097,45.32,1,1,24,24,湖內區
1600,2020-06-06 17:32:27,10559,281,44.29,10840,70,10910,23841,45.76,1,1,21,21,阿蓮區
1601,2020-06-06 17:32:27,4914,122,42.0,5036,23,5059,11699,43.24,1,1,12,12,永安區
1602,2020-06-06 17:32:28,201,24,6.01,225,2,227,3342,6.79,1,1,8,8,桃源區
1603,2020-06-06 17:32:28,2644,151,24.25,2795,35,2830,10198,27.75,1,0,12,11,六龜區
1604,2020-06-06 17:32:28,9573,411,28.06,9984,86,10070,33458,30.1,1,0,32,31,美濃區
1605,2020-06-06 17:32:28,1223,56,23.41,1279,16,1295,5224,24.79,1,1,7,7,甲仙區
1606,2020-06-06 17:32:28,3863,145,30.86,4008,56,4064,12517,32.47,1,1,18,18,內門區
1607,2020-06-06 17:32:28,11399,474,37.0,11873,78,11951,30807,38.79,1,1,35,35,旗山區
1608,2020-06-06 17:32:28,60,1,3.95,61,0,61,1520,4.01,1,1,3,3,茂林區
1609,2020-06-06 17:32:28,2733,121,26.69,2854,28,2882,10238,28.15,1,1,10,10,杉林區
1610,2020-06-06 17:32:28,209,7,8.95,216,0,216,2334,9.25,1,1,4,4,那瑪夏區
1611,2020-06-06 17:33:18,852593,22829,37.07,875422,4693,880115,2096698,41.98,38,28,1823,1685,高雄市
1612,2020-06-06 17:33:18,57732,1525,38.1,59257,270,59527,142309,41.83,1,0,99,94,楠梓區
1613,2020-06-06 17:33:18,55245,1366,34.94,56611,262,56873,152235,37.36,1,0,103,100,左營區
1614,2020-06-06 17:33:18,37814,847,33.34,38661,157,38818,95532,40.63,1,0,77,67,鼓山區
1615,2020-06-06 17:33:18,100676,2397,35.79,103073,484,103557,236534,43.78,1,0,189,163,三民區
1616,2020-06-06 17:33:18,9107,221,43.17,9328,57,9385,21094,44.49,1,1,24,24,鹽埕區
1617,2020-06-06 17:33:19,17452,443,40.21,17895,96,17991,43397,41.46,1,1,42,42,新興區
1618,2020-06-06 17:33:19,55515,1379,38.89,56894,287,57181,138975,41.14,1,0,116,113,苓雅區
1619,2020-06-06 17:33:19,66816,1779,42.48,68595,347,68942,157294,43.83,1,1,119,119,前鎮區
1620,2020-06-06 17:33:19,9437,252,39.81,9689,47,9736,23704,41.07,1,1,22,22,前金區
1621,2020-06-06 17:33:20,83250,2179,28.31,85429,442,85871,213514,40.22,1,0,228,170,鳳山區
1622,2020-06-06 17:33:20,25028,684,43.44,25712,194,25906,57617,44.96,1,1,51,51,林園區
1623,2020-06-06 17:33:20,10658,295,44.49,10953,58,11011,23954,45.97,1,1,18,18,旗津區
1624,2020-06-06 17:33:20,26501,674,27.9,27175,151,27326,65215,41.9,1,0,81,56,大寮區
1625,2020-06-06 17:33:20,53688,1378,41.43,55066,251,55317,126124,43.86,1,0,89,87,小港區
1626,2020-06-06 17:33:21,16662,412,42.76,17074,91,17165,38963,44.05,1,1,28,28,鳥松區
1627,2020-06-06 17:33:21,28761,800,36.35,29561,167,29728,71789,41.41,1,0,72,67,岡山區
1628,2020-06-06 17:33:21,15318,389,42.88,15707,89,15796,35719,44.22,1,1,32,32,大樹區
1629,2020-06-06 17:33:21,16254,507,49.89,16761,95,16856,32578,51.74,1,1,31,31,橋頭區
1630,2020-06-06 17:33:21,13320,363,45.49,13683,89,13772,29282,47.03,1,1,24,24,大社區
1631,2020-06-06 17:33:21,32787,886,44.32,33673,168,33841,73973,45.75,1,1,47,47,仁武區
1632,2020-06-06 17:33:21,2552,92,39.72,2644,21,2665,6425,41.48,1,1,12,12,田寮區
1633,2020-06-06 17:33:21,10618,306,41.88,10924,91,11015,25354,43.44,1,1,25,25,燕巢區
1634,2020-06-06 17:33:22,10559,281,44.29,10840,70,10910,23841,45.76,1,1,21,21,阿蓮區
1635,2020-06-06 17:33:22,18054,568,42.55,18622,111,18733,42432,44.15,1,1,41,41,路竹區
1636,2020-06-06 17:33:22,4914,122,42.0,5036,23,5059,11699,43.24,1,1,12,12,永安區
1637,2020-06-06 17:33:22,10600,315,41.54,10915,59,10974,25515,43.01,1,1,21,21,茄萣區
1638,2020-06-06 17:33:22,6173,193,38.78,6366,48,6414,15918,40.29,1,1,18,18,彌陀區
1639,2020-06-06 17:33:22,10929,369,43.55,11298,75,11373,25097,45.32,1,1,24,24,湖內區
1640,2020-06-06 17:33:23,14032,404,46.35,14436,87,14523,30272,47.98,1,1,28,28,梓官區
1641,2020-06-06 17:33:23,9573,411,28.06,9984,86,10070,33458,30.1,1,0,32,31,美濃區
1642,2020-06-06 17:33:23,11399,474,37.0,11873,78,11951,30807,38.79,1,1,35,35,旗山區
1643,2020-06-06 17:33:24,60,1,3.95,61,0,61,1520,4.01,1,1,3,3,茂林區
1644,2020-06-06 17:33:24,2880,164,26.41,3044,40,3084,10903,28.29,1,1,12,12,六龜區
1645,2020-06-06 17:33:24,1223,56,23.41,1279,16,1295,5224,24.79,1,1,7,7,甲仙區
1646,2020-06-06 17:33:24,2733,121,26.69,2854,28,2882,10238,28.15,1,1,10,10,杉林區
1647,2020-06-06 17:33:24,3863,145,30.86,4008,56,4064,12517,32.47,1,1,18,18,內門區
1648,2020-06-06 17:33:25,201,24,6.01,225,2,227,3342,6.79,1,1,8,8,桃源區
1649,2020-06-06 17:33:25,209,7,8.95,216,0,216,2334,9.25,1,1,4,4,那瑪夏區
1650,2020-06-06 17:34:15,57732,1525,38.1,59257,270,59527,142309,41.83,1,0,99,94,楠梓區
1651,2020-06-06 17:34:15,37814,847,33.34,38661,157,38818,95532,40.63,1,0,77,67,鼓山區
1652,2020-06-06 17:34:15,55245,1366,34.94,56611,262,56873,152235,37.36,1,0,103,100,左營區
1653,2020-06-06 17:34:15,9107,221,43.17,9328,57,9385,21094,44.49,1,1,24,24,鹽埕區
1654,2020-06-06 17:34:15,852593,22829,37.07,875422,4693,880115,2096698,41.98,38,28,1823,1685,高雄市
1655,2020-06-06 17:34:16,100676,2397,35.79,103073,484,103557,236534,43.78,1,0,189,163,三民區
1656,2020-06-06 17:34:16,9437,252,39.81,9689,47,9736,23704,41.07,1,1,22,22,前金區
1657,2020-06-06 17:34:16,83250,2179,28.31,85429,442,85871,213514,40.22,1,0,228,170,鳳山區
1658,2020-06-06 17:34:16,66816,1779,42.48,68595,347,68942,157294,43.83,1,1,119,119,前鎮區
1659,2020-06-06 17:34:16,10658,295,44.49,10953,58,11011,23954,45.97,1,1,18,18,旗津區
1660,2020-06-06 17:34:16,53688,1378,41.43,55066,251,55317,126124,43.86,1,0,89,87,小港區
1661,2020-06-06 17:34:16,55515,1379,38.89,56894,287,57181,138975,41.14,1,0,116,113,苓雅區
1662,2020-06-06 17:34:16,17452,443,40.21,17895,96,17991,43397,41.46,1,1,42,42,新興區
1663,2020-06-06 17:34:17,13320,363,45.49,13683,89,13772,29282,47.03,1,1,24,24,大社區
1664,2020-06-06 17:34:17,16662,412,42.76,17074,91,17165,38963,44.05,1,1,28,28,鳥松區
1665,2020-06-06 17:34:17,26501,674,27.9,27175,151,27326,65215,41.9,1,0,81,56,大寮區
1666,2020-06-06 17:34:17,25028,684,43.44,25712,194,25906,57617,44.96,1,1,51,51,林園區
1667,2020-06-06 17:34:17,32787,886,44.32,33673,168,33841,73973,45.75,1,1,47,47,仁武區
1668,2020-06-06 17:34:17,15318,389,42.88,15707,89,15796,35719,44.22,1,1,32,32,大樹區
1669,2020-06-06 17:34:18,10600,315,41.54,10915,59,10974,25515,43.01,1,1,21,21,茄萣區
1670,2020-06-06 17:34:18,2552,92,39.72,2644,21,2665,6425,41.48,1,1,12,12,田寮區
1671,2020-06-06 17:34:18,10559,281,44.29,10840,70,10910,23841,45.76,1,1,21,21,阿蓮區
1672,2020-06-06 17:34:18,10618,306,41.88,10924,91,11015,25354,43.44,1,1,25,25,燕巢區
1673,2020-06-06 17:34:18,18054,568,42.55,18622,111,18733,42432,44.15,1,1,41,41,路竹區
1674,2020-06-06 17:34:18,28761,800,36.35,29561,167,29728,71789,41.41,1,0,72,67,岡山區
1675,2020-06-06 17:34:18,10929,369,43.55,11298,75,11373,25097,45.32,1,1,24,24,湖內區
1676,2020-06-06 17:34:18,16254,507,49.89,16761,95,16856,32578,51.74,1,1,31,31,橋頭區
1677,2020-06-06 17:34:19,14032,404,46.35,14436,87,14523,30272,47.98,1,1,28,28,梓官區
1678,2020-06-06 17:34:19,11399,474,37.0,11873,78,11951,30807,38.79,1,1,35,35,旗山區
1679,2020-06-06 17:34:19,2880,164,26.41,3044,40,3084,10903,28.29,1,1,12,12,六龜區
1680,2020-06-06 17:34:19,3863,145,30.86,4008,56,4064,12517,32.47,1,1,18,18,內門區
1681,2020-06-06 17:34:19,4914,122,42.0,5036,23,5059,11699,43.24,1,1,12,12,永安區
1682,2020-06-06 17:34:19,2733,121,26.69,2854,28,2882,10238,28.15,1,1,10,10,杉林區
1683,2020-06-06 17:34:19,1223,56,23.41,1279,16,1295,5224,24.79,1,1,7,7,甲仙區
1684,2020-06-06 17:34:19,6173,193,38.78,6366,48,6414,15918,40.29,1,1,18,18,彌陀區
1685,2020-06-06 17:34:19,9573,411,28.06,9984,86,10070,33458,30.1,1,0,32,31,美濃區
1686,2020-06-06 17:34:20,201,24,6.01,225,2,227,3342,6.79,1,1,8,8,桃源區
1687,2020-06-06 17:34:20,209,7,8.95,216,0,216,2334,9.25,1,1,4,4,那瑪夏區
1688,2020-06-06 17:34:20,60,1,3.95,61,0,61,1520,4.01,1,1,3,3,茂林區
1689,2020-06-06 17:35:10,9107,221,43.17,9328,57,9385,21094,44.49,1,1,24,24,鹽埕區
1690,2020-06-06 17:35:10,852593,22829,37.07,875422,4693,880115,2096698,41.98,38,28,1823,1685,高雄市
1691,2020-06-06 17:35:10,55245,1366,34.94,56611,262,56873,152235,37.36,1,0,103,100,左營區
1692,2020-06-06 17:35:10,37814,847,33.34,38661,157,38818,95532,40.63,1,0,77,67,鼓山區
1693,2020-06-06 17:35:11,13320,363,45.49,13683,89,13772,29282,47.03,1,1,24,24,大社區
1694,2020-06-06 17:35:11,55515,1379,38.89,56894,287,57181,138975,41.14,1,0,116,113,苓雅區
1695,2020-06-06 17:35:11,17452,443,40.21,17895,96,17991,43397,41.46,1,1,42,42,新興區
1696,2020-06-06 17:35:11,15318,389,42.88,15707,89,15796,35719,44.22,1,1,32,32,大樹區
1697,2020-06-06 17:35:11,26501,674,27.9,27175,151,27326,65215,41.9,1,0,81,56,大寮區
1698,2020-06-06 17:35:11,9437,252,39.81,9689,47,9736,23704,41.07,1,1,22,22,前金區
1699,2020-06-06 17:35:11,83250,2179,28.31,85429,442,85871,213514,40.22,1,0,228,170,鳳山區
1700,2020-06-06 17:35:11,53688,1378,41.43,55066,251,55317,126124,43.86,1,0,89,87,小港區
1701,2020-06-06 17:35:11,25028,684,43.44,25712,194,25906,57617,44.96,1,1,51,51,林園區
1702,2020-06-06 17:35:11,100676,2397,35.79,103073,484,103557,236534,43.78,1,0,189,163,三民區
1703,2020-06-06 17:35:11,66816,1779,42.48,68595,347,68942,157294,43.83,1,1,119,119,前鎮區
1704,2020-06-06 17:35:11,10658,295,44.49,10953,58,11011,23954,45.97,1,1,18,18,旗津區
1705,2020-06-06 17:35:11,57732,1525,38.1,59257,270,59527,142309,41.83,1,0,99,94,楠梓區
1706,2020-06-06 17:35:12,10559,281,44.29,10840,70,10910,23841,45.76,1,1,21,21,阿蓮區
1707,2020-06-06 17:35:12,16662,412,42.76,17074,91,17165,38963,44.05,1,1,28,28,鳥松區
1708,2020-06-06 17:35:12,28761,800,36.35,29561,167,29728,71789,41.41,1,0,72,67,岡山區
1709,2020-06-06 17:35:12,4914,122,42.0,5036,23,5059,11699,43.24,1,1,12,12,永安區
1710,2020-06-06 17:35:12,32787,886,44.32,33673,168,33841,73973,45.75,1,1,47,47,仁武區
1711,2020-06-06 17:35:12,2552,92,39.72,2644,21,2665,6425,41.48,1,1,12,12,田寮區
1712,2020-06-06 17:35:12,6173,193,38.78,6366,48,6414,15918,40.29,1,1,18,18,彌陀區
1713,2020-06-06 17:35:12,16254,507,49.89,16761,95,16856,32578,51.74,1,1,31,31,橋頭區
1714,2020-06-06 17:35:12,10618,306,41.88,10924,91,11015,25354,43.44,1,1,25,25,燕巢區
1715,2020-06-06 17:35:12,10929,369,43.55,11298,75,11373,25097,45.32,1,1,24,24,湖內區
1716,2020-06-06 17:35:12,14032,404,46.35,14436,87,14523,30272,47.98,1,1,28,28,梓官區
1717,2020-06-06 17:35:12,18054,568,42.55,18622,111,18733,42432,44.15,1,1,41,41,路竹區
1718,2020-06-06 17:35:12,9573,411,28.06,9984,86,10070,33458,30.1,1,0,32,31,美濃區
1719,2020-06-06 17:35:12,11399,474,37.0,11873,78,11951,30807,38.79,1,1,35,35,旗山區
1720,2020-06-06 17:35:12,10600,315,41.54,10915,59,10974,25515,43.01,1,1,21,21,茄萣區
1721,2020-06-06 17:35:13,60,1,3.95,61,0,61,1520,4.01,1,1,3,3,茂林區
1722,2020-06-06 17:35:13,2733,121,26.69,2854,28,2882,10238,28.15,1,1,10,10,杉林區
1723,2020-06-06 17:35:13,201,24,6.01,225,2,227,3342,6.79,1,1,8,8,桃源區
1724,2020-06-06 17:35:13,2880,164,26.41,3044,40,3084,10903,28.29,1,1,12,12,六龜區
1725,2020-06-06 17:35:13,1223,56,23.41,1279,16,1295,5224,24.79,1,1,7,7,甲仙區
1726,2020-06-06 17:35:13,209,7,8.95,216,0,216,2334,9.25,1,1,4,4,那瑪夏區
1727,2020-06-06 17:35:13,3863,145,30.86,4008,56,4064,12517,32.47,1,1,18,18,內門區
1728,2020-06-06 17:36:03,55245,1366,34.94,56611,262,56873,152235,37.36,1,0,103,100,左營區
1729,2020-06-06 17:36:03,852593,22829,37.07,875422,4693,880115,2096698,41.98,38,28,1823,1685,高雄市
1730,2020-06-06 17:36:03,100676,2397,35.79,103073,484,103557,236534,43.78,1,0,189,163,三民區
1731,2020-06-06 17:36:03,37814,847,33.34,38661,157,38818,95532,40.63,1,0,77,67,鼓山區
1732,2020-06-06 17:36:03,9107,221,43.17,9328,57,9385,21094,44.49,1,1,24,24,鹽埕區
1733,2020-06-06 17:36:03,57732,1525,38.1,59257,270,59527,142309,41.83,1,0,99,94,楠梓區
1734,2020-06-06 17:36:03,17452,443,40.21,17895,96,17991,43397,41.46,1,1,42,42,新興區
1735,2020-06-06 17:36:03,9437,252,39.81,9689,47,9736,23704,41.07,1,1,22,22,前金區
1736,2020-06-06 17:36:04,16254,507,49.89,16761,95,16856,32578,51.74,1,1,31,31,橋頭區
1737,2020-06-06 17:36:04,13320,363,45.49,13683,89,13772,29282,47.03,1,1,24,24,大社區
1738,2020-06-06 17:36:04,26501,674,27.9,27175,151,27326,65215,41.9,1,0,81,56,大寮區
1739,2020-06-06 17:36:04,15318,389,42.88,15707,89,15796,35719,44.22,1,1,32,32,大樹區
1740,2020-06-06 17:36:04,16662,412,42.76,17074,91,17165,38963,44.05,1,1,28,28,鳥松區
1741,2020-06-06 17:36:04,25028,684,43.44,25712,194,25906,57617,44.96,1,1,51,51,林園區
1742,2020-06-06 17:36:04,55515,1379,38.89,56894,287,57181,138975,41.14,1,0,116,113,苓雅區
1743,2020-06-06 17:36:04,32787,886,44.32,33673,168,33841,73973,45.75,1,1,47,47,仁武區
1744,2020-06-06 17:36:04,53688,1378,41.43,55066,251,55317,126124,43.86,1,0,89,87,小港區
1745,2020-06-06 17:36:04,66816,1779,42.48,68595,347,68942,157294,43.83,1,1,119,119,前鎮區
1746,2020-06-06 17:36:04,83250,2179,28.31,85429,442,85871,213514,40.22,1,0,228,170,鳳山區
1747,2020-06-06 17:36:04,10658,295,44.49,10953,58,11011,23954,45.97,1,1,18,18,旗津區
1748,2020-06-06 17:36:04,28761,800,36.35,29561,167,29728,71789,41.41,1,0,72,67,岡山區
1749,2020-06-06 17:36:05,2552,92,39.72,2644,21,2665,6425,41.48,1,1,12,12,田寮區
1750,2020-06-06 17:36:05,10559,281,44.29,10840,70,10910,23841,45.76,1,1,21,21,阿蓮區
1751,2020-06-06 17:36:05,10618,306,41.88,10924,91,11015,25354,43.44,1,1,25,25,燕巢區
1752,2020-06-06 17:36:05,4914,122,42.0,5036,23,5059,11699,43.24,1,1,12,12,永安區
1753,2020-06-06 17:36:05,10929,369,43.55,11298,75,11373,25097,45.32,1,1,24,24,湖內區
1754,2020-06-06 17:36:05,18054,568,42.55,18622,111,18733,42432,44.15,1,1,41,41,路竹區
1755,2020-06-06 17:36:05,10600,315,41.54,10915,59,10974,25515,43.01,1,1,21,21,茄萣區
1756,2020-06-06 17:36:05,6173,193,38.78,6366,48,6414,15918,40.29,1,1,18,18,彌陀區
1757,2020-06-06 17:36:05,14032,404,46.35,14436,87,14523,30272,47.98,1,1,28,28,梓官區
1758,2020-06-06 17:36:05,11399,474,37.0,11873,78,11951,30807,38.79,1,1,35,35,旗山區
1759,2020-06-06 17:36:06,2880,164,26.41,3044,40,3084,10903,28.29,1,1,12,12,六龜區
1760,2020-06-06 17:36:06,9573,411,28.06,9984,86,10070,33458,30.1,1,0,32,31,美濃區
1761,2020-06-06 17:36:07,3863,145,30.86,4008,56,4064,12517,32.47,1,1,18,18,內門區
1762,2020-06-06 17:36:07,201,24,6.01,225,2,227,3342,6.79,1,1,8,8,桃源區
1763,2020-06-06 17:36:07,2733,121,26.69,2854,28,2882,10238,28.15,1,1,10,10,杉林區
1764,2020-06-06 17:36:07,1223,56,23.41,1279,16,1295,5224,24.79,1,1,7,7,甲仙區
1765,2020-06-06 17:36:07,209,7,8.95,216,0,216,2334,9.25,1,1,4,4,那瑪夏區
1766,2020-06-06 17:36:07,60,1,3.95,61,0,61,1520,4.01,1,1,3,3,茂林區
1767,2020-06-06 17:36:57,869126,23289,37.79,892415,4766,897181,2135006,42.02,38,28,1823,1710,高雄市
1768,2020-06-06 17:36:58,56469,1409,39.56,57878,294,58172,141250,41.18,1,0,116,115,苓雅區
1769,2020-06-06 17:36:58,25028,684,43.44,25712,194,25906,57617,44.96,1,1,51,51,林園區
1770,2020-06-06 17:36:58,10658,295,44.49,10953,58,11011,23954,45.97,1,1,18,18,旗津區
1771,2020-06-06 17:36:58,56012,1385,35.42,57397,265,57662,154151,37.41,1,0,103,101,左營區
1772,2020-06-06 17:36:58,9437,252,39.81,9689,47,9736,23704,41.07,1,1,22,22,前金區
1773,2020-06-06 17:36:58,40449,911,35.66,41360,169,41529,102874,40.37,1,0,77,71,鼓山區
1774,2020-06-06 17:36:58,17452,443,40.21,17895,96,17991,43397,41.46,1,1,42,42,新興區
1775,2020-06-06 17:36:58,53688,1378,41.43,55066,251,55317,126124,43.86,1,0,89,87,小港區
1776,2020-06-06 17:36:58,9107,221,43.17,9328,57,9385,21094,44.49,1,1,24,24,鹽埕區
1777,2020-06-06 17:36:58,106576,2553,37.89,109129,504,109633,249501,43.94,1,0,189,171,三民區
1778,2020-06-06 17:36:58,66816,1779,42.48,68595,347,68942,157294,43.83,1,1,119,119,前鎮區
1779,2020-06-06 17:36:58,59307,1565,39.14,60872,275,61147,145775,41.95,1,0,99,96,楠梓區
1780,2020-06-06 17:36:58,85438,2238,29.05,87676,452,88128,218366,40.36,1,0,228,174,鳳山區
1781,2020-06-06 17:36:58,27799,714,29.27,28513,158,28671,67945,42.2,1,0,81,58,大寮區
1782,2020-06-06 17:36:58,15318,389,42.88,15707,89,15796,35719,44.22,1,1,32,32,大樹區
1783,2020-06-06 17:36:59,4914,122,42.0,5036,23,5059,11699,43.24,1,1,12,12,永安區
1784,2020-06-06 17:36:59,16254,507,49.89,16761,95,16856,32578,51.74,1,1,31,31,橋頭區
1785,2020-06-06 17:36:59,10600,315,41.54,10915,59,10974,25515,43.01,1,1,21,21,茄萣區
1786,2020-06-06 17:36:59,10618,306,41.88,10924,91,11015,25354,43.44,1,1,25,25,燕巢區
1787,2020-06-06 17:36:59,11399,474,37.0,11873,78,11951,30807,38.79,1,1,35,35,旗山區
1788,2020-06-06 17:36:59,2552,92,39.72,2644,21,2665,6425,41.48,1,1,12,12,田寮區
1789,2020-06-06 17:36:59,18054,568,42.55,18622,111,18733,42432,44.15,1,1,41,41,路竹區
1790,2020-06-06 17:36:59,16662,412,42.76,17074,91,17165,38963,44.05,1,1,28,28,鳥松區
1791,2020-06-06 17:36:59,6173,193,38.78,6366,48,6414,15918,40.29,1,1,18,18,彌陀區
1792,2020-06-06 17:36:59,32787,886,44.32,33673,168,33841,73973,45.75,1,1,47,47,仁武區
1793,2020-06-06 17:36:59,13320,363,45.49,13683,89,13772,29282,47.03,1,1,24,24,大社區
1794,2020-06-06 17:36:59,10929,369,43.55,11298,75,11373,25097,45.32,1,1,24,24,湖內區
1795,2020-06-06 17:36:59,29977,852,37.89,30829,176,31005,74549,41.59,1,0,72,69,岡山區
1796,2020-06-06 17:36:59,10559,281,44.29,10840,70,10910,23841,45.76,1,1,21,21,阿蓮區
1797,2020-06-06 17:36:59,14032,404,46.35,14436,87,14523,30272,47.98,1,1,28,28,梓官區
1798,2020-06-06 17:37:00,9573,411,28.06,9984,86,10070,33458,30.1,1,0,32,31,美濃區
1799,2020-06-06 17:37:00,3863,145,30.86,4008,56,4064,12517,32.47,1,1,18,18,內門區
1800,2020-06-06 17:37:00,2880,164,26.41,3044,40,3084,10903,28.29,1,1,12,12,六龜區
1801,2020-06-06 17:37:00,60,1,3.95,61,0,61,1520,4.01,1,1,3,3,茂林區
1802,2020-06-06 17:37:00,1223,56,23.41,1279,16,1295,5224,24.79,1,1,7,7,甲仙區
1803,2020-06-06 17:37:00,201,24,6.01,225,2,227,3342,6.79,1,1,8,8,桃源區
1804,2020-06-06 17:37:00,209,7,8.95,216,0,216,2334,9.25,1,1,4,4,那瑪夏區
1805,2020-06-06 17:37:00,2733,121,26.69,2854,28,2882,10238,28.15,1,1,10,10,杉林區
1806,2020-06-06 17:37:51,9437,252,39.81,9689,47,9736,23704,41.07,1,1,22,22,前金區
1807,2020-06-06 17:37:51,106576,2553,37.89,109129,504,109633,249501,43.94,1,0,189,171,三民區
1808,2020-06-06 17:37:51,56469,1409,39.56,57878,294,58172,141250,41.18,1,0,116,115,苓雅區
1809,2020-06-06 17:37:51,66816,1779,42.48,68595,347,68942,157294,43.83,1,1,119,119,前鎮區
1810,2020-06-06 17:37:51,17452,443,40.21,17895,96,17991,43397,41.46,1,1,42,42,新興區
1811,2020-06-06 17:37:51,9107,221,43.17,9328,57,9385,21094,44.49,1,1,24,24,鹽埕區
1812,2020-06-06 17:37:51,40449,911,35.66,41360,169,41529,102874,40.37,1,0,77,71,鼓山區
1813,2020-06-06 17:37:51,56012,1385,35.42,57397,265,57662,154151,37.41,1,0,103,101,左營區
1814,2020-06-06 17:37:51,10658,295,44.49,10953,58,11011,23954,45.97,1,1,18,18,旗津區
1815,2020-06-06 17:37:51,53688,1378,41.43,55066,251,55317,126124,43.86,1,0,89,87,小港區
1816,2020-06-06 17:37:51,869126,23289,37.79,892415,4766,897181,2135006,42.02,38,28,1823,1710,高雄市
1817,2020-06-06 17:37:51,59307,1565,39.14,60872,275,61147,145775,41.95,1,0,99,96,楠梓區
1818,2020-06-06 17:37:52,16254,507,49.89,16761,95,16856,32578,51.74,1,1,31,31,橋頭區
1819,2020-06-06 17:37:52,13320,363,45.49,13683,89,13772,29282,47.03,1,1,24,24,大社區
1820,2020-06-06 17:37:52,32787,886,44.32,33673,168,33841,73973,45.75,1,1,47,47,仁武區
1821,2020-06-06 17:37:52,27799,714,29.27,28513,158,28671,67945,42.2,1,0,81,58,大寮區
1822,2020-06-06 17:37:52,25028,684,43.44,25712,194,25906,57617,44.96,1,1,51,51,林園區
1823,2020-06-06 17:37:52,85438,2238,29.05,87676,452,88128,218366,40.36,1,0,228,174,鳳山區
1824,2020-06-06 17:37:52,10618,306,41.88,10924,91,11015,25354,43.44,1,1,25,25,燕巢區
1825,2020-06-06 17:37:52,29977,852,37.89,30829,176,31005,74549,41.59,1,0,72,69,岡山區
1826,2020-06-06 17:37:52,16662,412,42.76,17074,91,17165,38963,44.05,1,1,28,28,鳥松區
1827,2020-06-06 17:37:52,15318,389,42.88,15707,89,15796,35719,44.22,1,1,32,32,大樹區
1828,2020-06-06 17:37:53,6173,193,38.78,6366,48,6414,15918,40.29,1,1,18,18,彌陀區
1829,2020-06-06 17:37:53,10600,315,41.54,10915,59,10974,25515,43.01,1,1,21,21,茄萣區
1830,2020-06-06 17:37:53,11399,474,37.0,11873,78,11951,30807,38.79,1,1,35,35,旗山區
1831,2020-06-06 17:37:53,10929,369,43.55,11298,75,11373,25097,45.32,1,1,24,24,湖內區
1832,2020-06-06 17:37:53,2552,92,39.72,2644,21,2665,6425,41.48,1,1,12,12,田寮區
1833,2020-06-06 17:37:53,4914,122,42.0,5036,23,5059,11699,43.24,1,1,12,12,永安區
1834,2020-06-06 17:37:53,18054,568,42.55,18622,111,18733,42432,44.15,1,1,41,41,路竹區
1835,2020-06-06 17:37:53,10559,281,44.29,10840,70,10910,23841,45.76,1,1,21,21,阿蓮區
1836,2020-06-06 17:37:53,14032,404,46.35,14436,87,14523,30272,47.98,1,1,28,28,梓官區
1837,2020-06-06 17:37:54,60,1,3.95,61,0,61,1520,4.01,1,1,3,3,茂林區
1838,2020-06-06 17:37:54,2733,121,26.69,2854,28,2882,10238,28.15,1,1,10,10,杉林區
1839,2020-06-06 17:37:54,3863,145,30.86,4008,56,4064,12517,32.47,1,1,18,18,內門區
1840,2020-06-06 17:37:54,201,24,6.01,225,2,227,3342,6.79,1,1,8,8,桃源區
1841,2020-06-06 17:37:54,209,7,8.95,216,0,216,2334,9.25,1,1,4,4,那瑪夏區
1842,2020-06-06 17:37:54,2880,164,26.41,3044,40,3084,10903,28.29,1,1,12,12,六龜區
1843,2020-06-06 17:37:54,1223,56,23.41,1279,16,1295,5224,24.79,1,1,7,7,甲仙區
1844,2020-06-06 17:37:54,9573,411,28.06,9984,86,10070,33458,30.1,1,0,32,31,美濃區
1845,2020-06-06 17:38:44,40449,911,35.66,41360,169,41529,102874,40.37,1,0,77,71,鼓山區
1846,2020-06-06 17:38:44,9107,221,43.17,9328,57,9385,21094,44.49,1,1,24,24,鹽埕區
1847,2020-06-06 17:38:44,869126,23289,37.79,892415,4766,897181,2135006,42.02,38,28,1823,1710,高雄市
1848,2020-06-06 17:38:45,25028,684,43.44,25712,194,25906,57617,44.96,1,1,51,51,林園區
1849,2020-06-06 17:38:45,66816,1779,42.48,68595,347,68942,157294,43.83,1,1,119,119,前鎮區
1850,2020-06-06 17:38:45,27799,714,29.27,28513,158,28671,67945,42.2,1,0,81,58,大寮區
1851,2020-06-06 17:38:45,10658,295,44.49,10953,58,11011,23954,45.97,1,1,18,18,旗津區
1852,2020-06-06 17:38:45,17452,443,40.21,17895,96,17991,43397,41.46,1,1,42,42,新興區
1853,2020-06-06 17:38:45,85438,2238,29.05,87676,452,88128,218366,40.36,1,0,228,174,鳳山區
1854,2020-06-06 17:38:45,9437,252,39.81,9689,47,9736,23704,41.07,1,1,22,22,前金區
1855,2020-06-06 17:38:45,59307,1565,39.14,60872,275,61147,145775,41.95,1,0,99,96,楠梓區
1856,2020-06-06 17:38:45,53688,1378,41.43,55066,251,55317,126124,43.86,1,0,89,87,小港區
1857,2020-06-06 17:38:45,15318,389,42.88,15707,89,15796,35719,44.22,1,1,32,32,大樹區
1858,2020-06-06 17:38:45,106576,2553,37.89,109129,504,109633,249501,43.94,1,0,189,171,三民區
1859,2020-06-06 17:38:45,13320,363,45.49,13683,89,13772,29282,47.03,1,1,24,24,大社區
1860,2020-06-06 17:38:45,56469,1409,39.56,57878,294,58172,141250,41.18,1,0,116,115,苓雅區
1861,2020-06-06 17:38:45,56012,1385,35.42,57397,265,57662,154151,37.41,1,0,103,101,左營區
1862,2020-06-06 17:38:46,10618,306,41.88,10924,91,11015,25354,43.44,1,1,25,25,燕巢區
1863,2020-06-06 17:38:46,16662,412,42.76,17074,91,17165,38963,44.05,1,1,28,28,鳥松區
1864,2020-06-06 17:38:46,29977,852,37.89,30829,176,31005,74549,41.59,1,0,72,69,岡山區
1865,2020-06-06 17:38:46,32787,886,44.32,33673,168,33841,73973,45.75,1,1,47,47,仁武區
1866,2020-06-06 17:38:46,16254,507,49.89,16761,95,16856,32578,51.74,1,1,31,31,橋頭區
1867,2020-06-06 17:38:47,2552,92,39.72,2644,21,2665,6425,41.48,1,1,12,12,田寮區
1868,2020-06-06 17:38:47,10559,281,44.29,10840,70,10910,23841,45.76,1,1,21,21,阿蓮區
1869,2020-06-06 17:38:47,4914,122,42.0,5036,23,5059,11699,43.24,1,1,12,12,永安區
1870,2020-06-06 17:38:47,10929,369,43.55,11298,75,11373,25097,45.32,1,1,24,24,湖內區
1871,2020-06-06 17:38:47,11399,474,37.0,11873,78,11951,30807,38.79,1,1,35,35,旗山區
1872,2020-06-06 17:38:47,18054,568,42.55,18622,111,18733,42432,44.15,1,1,41,41,路竹區
1873,2020-06-06 17:38:47,6173,193,38.78,6366,48,6414,15918,40.29,1,1,18,18,彌陀區
1874,2020-06-06 17:38:47,10600,315,41.54,10915,59,10974,25515,43.01,1,1,21,21,茄萣區
1875,2020-06-06 17:38:47,14032,404,46.35,14436,87,14523,30272,47.98,1,1,28,28,梓官區
1876,2020-06-06 17:38:48,209,7,8.95,216,0,216,2334,9.25,1,1,4,4,那瑪夏區
1877,2020-06-06 17:38:48,201,24,6.01,225,2,227,3342,6.79,1,1,8,8,桃源區
1878,2020-06-06 17:38:48,3863,145,30.86,4008,56,4064,12517,32.47,1,1,18,18,內門區
1879,2020-06-06 17:38:48,9573,411,28.06,9984,86,10070,33458,30.1,1,0,32,31,美濃區
1880,2020-06-06 17:38:48,60,1,3.95,61,0,61,1520,4.01,1,1,3,3,茂林區
1881,2020-06-06 17:38:48,2880,164,26.41,3044,40,3084,10903,28.29,1,1,12,12,六龜區
1882,2020-06-06 17:38:48,2733,121,26.69,2854,28,2882,10238,28.15,1,1,10,10,杉林區
1883,2020-06-06 17:38:48,1223,56,23.41,1279,16,1295,5224,24.79,1,1,7,7,甲仙區
1884,2020-06-06 17:39:39,9437,252,39.81,9689,47,9736,23704,41.07,1,1,22,22,前金區
1885,2020-06-06 17:39:39,60061,1587,39.64,61648,277,61925,147664,41.94,1,0,99,97,楠梓區
1886,2020-06-06 17:39:39,9107,221,43.17,9328,57,9385,21094,44.49,1,1,24,24,鹽埕區
1887,2020-06-06 17:39:39,56868,1399,35.97,58267,268,58535,156338,37.44,1,0,103,102,左營區
1888,2020-06-06 17:39:39,54333,1393,41.92,55726,257,55983,127470,43.92,1,0,89,88,小港區
1889,2020-06-06 17:39:39,17452,443,40.21,17895,96,17991,43397,41.46,1,1,42,42,新興區
1890,2020-06-06 17:39:39,109833,2623,39.05,112456,518,112974,256956,43.97,1,0,189,175,三民區
1891,2020-06-06 17:39:39,56469,1409,39.56,57878,294,58172,141250,41.18,1,0,116,115,苓雅區
1892,2020-06-06 17:39:39,66816,1779,42.48,68595,347,68942,157294,43.83,1,1,119,119,前鎮區
1893,2020-06-06 17:39:39,883568,23642,38.42,907210,4837,912047,2168758,42.05,38,29,1823,1732,高雄市
1894,2020-06-06 17:39:39,10658,295,44.49,10953,58,11011,23954,45.97,1,1,18,18,旗津區
1895,2020-06-06 17:39:39,41102,926,36.24,42028,174,42202,104741,40.29,1,0,77,72,鼓山區
1896,2020-06-06 17:39:40,32787,886,44.32,33673,168,33841,73973,45.75,1,1,47,47,仁武區
1897,2020-06-06 17:39:40,25028,684,43.44,25712,194,25906,57617,44.96,1,1,51,51,林園區
1898,2020-06-06 17:39:40,10618,306,41.88,10924,91,11015,25354,43.44,1,1,25,25,燕巢區
1899,2020-06-06 17:39:40,16662,412,42.76,17074,91,17165,38963,44.05,1,1,28,28,鳥松區
1900,2020-06-06 17:39:40,27799,714,29.27,28513,158,28671,67945,42.2,1,0,81,58,大寮區
1901,2020-06-06 17:39:40,13320,363,45.49,13683,89,13772,29282,47.03,1,1,24,24,大社區
1902,2020-06-06 17:39:40,16254,507,49.89,16761,95,16856,32578,51.74,1,1,31,31,橋頭區
1903,2020-06-06 17:39:40,15318,389,42.88,15707,89,15796,35719,44.22,1,1,32,32,大樹區
1904,2020-06-06 17:39:40,92131,2419,31.33,94550,485,95035,233895,40.63,1,0,228,185,鳳山區
1905,2020-06-06 17:39:40,31385,879,39.67,32264,182,32446,77374,41.93,1,0,72,71,岡山區
1906,2020-06-06 17:39:41,10929,369,43.55,11298,75,11373,25097,45.32,1,1,24,24,湖內區
1907,2020-06-06 17:39:41,10559,281,44.29,10840,70,10910,23841,45.76,1,1,21,21,阿蓮區
1908,2020-06-06 17:39:41,18054,568,42.55,18622,111,18733,42432,44.15,1,1,41,41,路竹區
1909,2020-06-06 17:39:41,2552,92,39.72,2644,21,2665,6425,41.48,1,1,12,12,田寮區
1910,2020-06-06 17:39:42,4914,122,42.0,5036,23,5059,11699,43.24,1,1,12,12,永安區
1911,2020-06-06 17:39:42,10600,315,41.54,10915,59,10974,25515,43.01,1,1,21,21,茄萣區
1912,2020-06-06 17:39:42,14032,404,46.35,14436,87,14523,30272,47.98,1,1,28,28,梓官區
1913,2020-06-06 17:39:42,6173,193,38.78,6366,48,6414,15918,40.29,1,1,18,18,彌陀區
1914,2020-06-06 17:39:43,9749,420,28.58,10169,88,10257,34112,30.07,1,1,32,32,美濃區
1915,2020-06-06 17:39:43,11399,474,37.0,11873,78,11951,30807,38.79,1,1,35,35,旗山區
1916,2020-06-06 17:39:43,2733,121,26.69,2854,28,2882,10238,28.15,1,1,10,10,杉林區
1917,2020-06-06 17:39:43,1223,56,23.41,1279,16,1295,5224,24.79,1,1,7,7,甲仙區
1918,2020-06-06 17:39:43,2880,164,26.41,3044,40,3084,10903,28.29,1,1,12,12,六龜區
1919,2020-06-06 17:39:44,3863,145,30.86,4008,56,4064,12517,32.47,1,1,18,18,內門區
1920,2020-06-06 17:39:44,209,7,8.95,216,0,216,2334,9.25,1,1,4,4,那瑪夏區
1921,2020-06-06 17:39:44,60,1,3.95,61,0,61,1520,4.01,1,1,3,3,茂林區
1922,2020-06-06 17:39:44,201,24,6.01,225,2,227,3342,6.79,1,1,8,8,桃源區
1923,2020-06-06 17:40:34,17452,443,40.21,17895,96,17991,43397,41.46,1,1,42,42,新興區
1924,2020-06-06 17:40:34,41102,926,36.24,42028,174,42202,104741,40.29,1,0,77,72,鼓山區
1925,2020-06-06 17:40:34,56868,1399,35.97,58267,268,58535,156338,37.44,1,0,103,102,左營區
1926,2020-06-06 17:40:34,9437,252,39.81,9689,47,9736,23704,41.07,1,1,22,22,前金區
1927,2020-06-06 17:40:34,883568,23642,38.42,907210,4837,912047,2168758,42.05,38,29,1823,1732,高雄市
1928,2020-06-06 17:40:34,109833,2623,39.05,112456,518,112974,256956,43.97,1,0,189,175,三民區
1929,2020-06-06 17:40:34,9107,221,43.17,9328,57,9385,21094,44.49,1,1,24,24,鹽埕區
1930,2020-06-06 17:40:34,60061,1587,39.64,61648,277,61925,147664,41.94,1,0,99,97,楠梓區
1931,2020-06-06 17:40:35,10658,295,44.49,10953,58,11011,23954,45.97,1,1,18,18,旗津區
1932,2020-06-06 17:40:35,56469,1409,39.56,57878,294,58172,141250,41.18,1,0,116,115,苓雅區
1933,2020-06-06 17:40:35,66816,1779,42.48,68595,347,68942,157294,43.83,1,1,119,119,前鎮區
1934,2020-06-06 17:40:36,54333,1393,41.92,55726,257,55983,127470,43.92,1,0,89,88,小港區
1935,2020-06-06 17:40:36,25028,684,43.44,25712,194,25906,57617,44.96,1,1,51,51,林園區
1936,2020-06-06 17:40:36,92131,2419,31.33,94550,485,95035,233895,40.63,1,0,228,185,鳳山區
1937,2020-06-06 17:40:37,16662,412,42.76,17074,91,17165,38963,44.05,1,1,28,28,鳥松區
1938,2020-06-06 17:40:37,31385,879,39.67,32264,182,32446,77374,41.93,1,0,72,71,岡山區
1939,2020-06-06 17:40:37,15318,389,42.88,15707,89,15796,35719,44.22,1,1,32,32,大樹區
1940,2020-06-06 17:40:37,32787,886,44.32,33673,168,33841,73973,45.75,1,1,47,47,仁武區
1941,2020-06-06 17:40:37,27799,714,29.27,28513,158,28671,67945,42.2,1,0,81,58,大寮區
1942,2020-06-06 17:40:37,13320,363,45.49,13683,89,13772,29282,47.03,1,1,24,24,大社區
1943,2020-06-06 17:40:38,16254,507,49.89,16761,95,16856,32578,51.74,1,1,31,31,橋頭區
1944,2020-06-06 17:40:38,10929,369,43.55,11298,75,11373,25097,45.32,1,1,24,24,湖內區
1945,2020-06-06 17:40:38,18054,568,42.55,18622,111,18733,42432,44.15,1,1,41,41,路竹區
1946,2020-06-06 17:40:38,10559,281,44.29,10840,70,10910,23841,45.76,1,1,21,21,阿蓮區
1947,2020-06-06 17:40:38,10600,315,41.54,10915,59,10974,25515,43.01,1,1,21,21,茄萣區
1948,2020-06-06 17:40:38,2552,92,39.72,2644,21,2665,6425,41.48,1,1,12,12,田寮區
1949,2020-06-06 17:40:38,10618,306,41.88,10924,91,11015,25354,43.44,1,1,25,25,燕巢區
1950,2020-06-06 17:40:39,4914,122,42.0,5036,23,5059,11699,43.24,1,1,12,12,永安區
1951,2020-06-06 17:40:39,14032,404,46.35,14436,87,14523,30272,47.98,1,1,28,28,梓官區
1952,2020-06-06 17:40:39,6173,193,38.78,6366,48,6414,15918,40.29,1,1,18,18,彌陀區
1953,2020-06-06 17:40:39,11399,474,37.0,11873,78,11951,30807,38.79,1,1,35,35,旗山區
1954,2020-06-06 17:40:40,1223,56,23.41,1279,16,1295,5224,24.79,1,1,7,7,甲仙區
1955,2020-06-06 17:40:40,2880,164,26.41,3044,40,3084,10903,28.29,1,1,12,12,六龜區
1956,2020-06-06 17:40:40,9749,420,28.58,10169,88,10257,34112,30.07,1,1,32,32,美濃區
1957,2020-06-06 17:40:41,2733,121,26.69,2854,28,2882,10238,28.15,1,1,10,10,杉林區
1958,2020-06-06 17:40:41,3863,145,30.86,4008,56,4064,12517,32.47,1,1,18,18,內門區
1959,2020-06-06 17:40:41,60,1,3.95,61,0,61,1520,4.01,1,1,3,3,茂林區
1960,2020-06-06 17:40:41,209,7,8.95,216,0,216,2334,9.25,1,1,4,4,那瑪夏區
1961,2020-06-06 17:40:41,201,24,6.01,225,2,227,3342,6.79,1,1,8,8,桃源區
1962,2020-06-06 17:41:31,883568,23642,38.42,907210,4837,912047,2168758,42.05,38,29,1823,1732,高雄市
1963,2020-06-06 17:41:31,56868,1399,35.97,58267,268,58535,156338,37.44,1,0,103,102,左營區
1964,2020-06-06 17:41:31,41102,926,36.24,42028,174,42202,104741,40.29,1,0,77,72,鼓山區
1965,2020-06-06 17:41:31,60061,1587,39.64,61648,277,61925,147664,41.94,1,0,99,97,楠梓區
1966,2020-06-06 17:41:31,9107,221,43.17,9328,57,9385,21094,44.49,1,1,24,24,鹽埕區
1967,2020-06-06 17:41:32,17452,443,40.21,17895,96,17991,43397,41.46,1,1,42,42,新興區
1968,2020-06-06 17:41:32,9437,252,39.81,9689,47,9736,23704,41.07,1,1,22,22,前金區
1969,2020-06-06 17:41:32,109833,2623,39.05,112456,518,112974,256956,43.97,1,0,189,175,三民區
1970,2020-06-06 17:41:32,66816,1779,42.48,68595,347,68942,157294,43.83,1,1,119,119,前鎮區
1971,2020-06-06 17:41:32,56469,1409,39.56,57878,294,58172,141250,41.18,1,0,116,115,苓雅區
1972,2020-06-06 17:41:33,25028,684,43.44,25712,194,25906,57617,44.96,1,1,51,51,林園區
1973,2020-06-06 17:41:33,15318,389,42.88,15707,89,15796,35719,44.22,1,1,32,32,大樹區
1974,2020-06-06 17:41:33,27799,714,29.27,28513,158,28671,67945,42.2,1,0,81,58,大寮區
1975,2020-06-06 17:41:33,13320,363,45.49,13683,89,13772,29282,47.03,1,1,24,24,大社區
1976,2020-06-06 17:41:33,92131,2419,31.33,94550,485,95035,233895,40.63,1,0,228,185,鳳山區
1977,2020-06-06 17:41:33,10658,295,44.49,10953,58,11011,23954,45.97,1,1,18,18,旗津區
1978,2020-06-06 17:41:33,54333,1393,41.92,55726,257,55983,127470,43.92,1,0,89,88,小港區
1979,2020-06-06 17:41:34,16254,507,49.89,16761,95,16856,32578,51.74,1,1,31,31,橋頭區
1980,2020-06-06 17:41:34,16662,412,42.76,17074,91,17165,38963,44.05,1,1,28,28,鳥松區
1981,2020-06-06 17:41:34,31385,879,39.67,32264,182,32446,77374,41.93,1,0,72,71,岡山區
1982,2020-06-06 17:41:34,32787,886,44.32,33673,168,33841,73973,45.75,1,1,47,47,仁武區
1983,2020-06-06 17:41:35,10618,306,41.88,10924,91,11015,25354,43.44,1,1,25,25,燕巢區
1984,2020-06-06 17:41:35,2552,92,39.72,2644,21,2665,6425,41.48,1,1,12,12,田寮區
1985,2020-06-06 17:41:36,10929,369,43.55,11298,75,11373,25097,45.32,1,1,24,24,湖內區
1986,2020-06-06 17:41:36,10559,281,44.29,10840,70,10910,23841,45.76,1,1,21,21,阿蓮區
1987,2020-06-06 17:41:36,18054,568,42.55,18622,111,18733,42432,44.15,1,1,41,41,路竹區
1988,2020-06-06 17:41:36,10600,315,41.54,10915,59,10974,25515,43.01,1,1,21,21,茄萣區
1989,2020-06-06 17:41:37,60,1,3.95,61,0,61,1520,4.01,1,1,3,3,茂林區
1990,2020-06-06 17:41:37,201,24,6.01,225,2,227,3342,6.79,1,1,8,8,桃源區
1991,2020-06-06 17:41:37,1223,56,23.41,1279,16,1295,5224,24.79,1,1,7,7,甲仙區
1992,2020-06-06 17:41:37,2880,164,26.41,3044,40,3084,10903,28.29,1,1,12,12,六龜區
1993,2020-06-06 17:41:37,2733,121,26.69,2854,28,2882,10238,28.15,1,1,10,10,杉林區
1994,2020-06-06 17:41:37,14032,404,46.35,14436,87,14523,30272,47.98,1,1,28,28,梓官區
1995,2020-06-06 17:41:37,6173,193,38.78,6366,48,6414,15918,40.29,1,1,18,18,彌陀區
1996,2020-06-06 17:41:37,3863,145,30.86,4008,56,4064,12517,32.47,1,1,18,18,內門區
1997,2020-06-06 17:41:37,4914,122,42.0,5036,23,5059,11699,43.24,1,1,12,12,永安區
1998,2020-06-06 17:41:37,11399,474,37.0,11873,78,11951,30807,38.79,1,1,35,35,旗山區
1999,2020-06-06 17:41:37,9749,420,28.58,10169,88,10257,34112,30.07,1,1,32,32,美濃區
2000,2020-06-06 17:41:38,209,7,8.95,216,0,216,2334,9.25,1,1,4,4,那瑪夏區
2001,2020-06-06 17:42:28,111643,2663,39.69,114306,527,114833,260604,44.06,1,0,189,177,三民區
2002,2020-06-06 17:42:28,60061,1587,39.64,61648,277,61925,147664,41.94,1,0,99,97,楠梓區
2003,2020-06-06 17:42:28,9107,221,43.17,9328,57,9385,21094,44.49,1,1,24,24,鹽埕區
2004,2020-06-06 17:42:28,57508,1416,36.37,58924,271,59195,158116,37.44,1,1,103,103,左營區
2005,2020-06-06 17:42:28,41798,947,36.85,42745,175,42920,106570,40.27,1,0,77,73,鼓山區
2006,2020-06-06 17:42:28,895007,23898,38.91,918905,4900,923805,2194141,42.1,38,32,1823,1750,高雄市
2007,2020-06-06 17:42:29,10658,295,44.49,10953,58,11011,23954,45.97,1,1,18,18,旗津區
2008,2020-06-06 17:42:29,55361,1415,42.72,56776,259,57035,129597,44.01,1,1,89,89,小港區
2009,2020-06-06 17:42:29,17452,443,40.21,17895,96,17991,43397,41.46,1,1,42,42,新興區
2010,2020-06-06 17:42:29,97529,2536,33.16,100065,517,100582,245857,40.91,1,0,228,194,鳳山區
2011,2020-06-06 17:42:29,9437,252,39.81,9689,47,9736,23704,41.07,1,1,22,22,前金區
2012,2020-06-06 17:42:29,66816,1779,42.48,68595,347,68942,157294,43.83,1,1,119,119,前鎮區
2013,2020-06-06 17:42:29,56469,1409,39.56,57878,294,58172,141250,41.18,1,0,116,115,苓雅區
2014,2020-06-06 17:42:30,15318,389,42.88,15707,89,15796,35719,44.22,1,1,32,32,大樹區
2015,2020-06-06 17:42:30,28967,737,30.5,29704,166,29870,70245,42.52,1,0,81,61,大寮區
2016,2020-06-06 17:42:30,25028,684,43.44,25712,194,25906,57617,44.96,1,1,51,51,林園區
2017,2020-06-06 17:42:31,32084,895,40.55,32979,190,33169,79113,41.93,1,1,72,72,岡山區
2018,2020-06-06 17:42:31,16662,412,42.76,17074,91,17165,38963,44.05,1,1,28,28,鳥松區
2019,2020-06-06 17:42:31,16254,507,49.89,16761,95,16856,32578,51.74,1,1,31,31,橋頭區
2020,2020-06-06 17:42:31,32787,886,44.32,33673,168,33841,73973,45.75,1,1,47,47,仁武區
2021,2020-06-06 17:42:31,13320,363,45.49,13683,89,13772,29282,47.03,1,1,24,24,大社區
2022,2020-06-06 17:42:32,10600,315,41.54,10915,59,10974,25515,43.01,1,1,21,21,茄萣區
2023,2020-06-06 17:42:32,2552,92,39.72,2644,21,2665,6425,41.48,1,1,12,12,田寮區
2024,2020-06-06 17:42:32,6173,193,38.78,6366,48,6414,15918,40.29,1,1,18,18,彌陀區
2025,2020-06-06 17:42:32,4914,122,42.0,5036,23,5059,11699,43.24,1,1,12,12,永安區
2026,2020-06-06 17:42:32,10618,306,41.88,10924,91,11015,25354,43.44,1,1,25,25,燕巢區
2027,2020-06-06 17:42:32,18054,568,42.55,18622,111,18733,42432,44.15,1,1,41,41,路竹區
2028,2020-06-06 17:42:32,10559,281,44.29,10840,70,10910,23841,45.76,1,1,21,21,阿蓮區
2029,2020-06-06 17:42:32,10929,369,43.55,11298,75,11373,25097,45.32,1,1,24,24,湖內區
2030,2020-06-06 17:42:33,2880,164,26.41,3044,40,3084,10903,28.29,1,1,12,12,六龜區
2031,2020-06-06 17:42:33,9749,420,28.58,10169,88,10257,34112,30.07,1,1,32,32,美濃區
2032,2020-06-06 17:42:33,11399,474,37.0,11873,78,11951,30807,38.79,1,1,35,35,旗山區
2033,2020-06-06 17:42:33,14032,404,46.35,14436,87,14523,30272,47.98,1,1,28,28,梓官區
2034,2020-06-06 17:42:33,2733,121,26.69,2854,28,2882,10238,28.15,1,1,10,10,杉林區
2035,2020-06-06 17:42:33,1223,56,23.41,1279,16,1295,5224,24.79,1,1,7,7,甲仙區
2036,2020-06-06 17:42:34,209,7,8.95,216,0,216,2334,9.25,1,1,4,4,那瑪夏區
2037,2020-06-06 17:42:34,60,1,3.95,61,0,61,1520,4.01,1,1,3,3,茂林區
2038,2020-06-06 17:42:34,3863,145,30.86,4008,56,4064,12517,32.47,1,1,18,18,內門區
2039,2020-06-06 17:42:34,201,24,6.01,225,2,227,3342,6.79,1,1,8,8,桃源區
2040,2020-06-06 17:43:24,895007,23898,38.91,918905,4900,923805,2194141,42.1,38,32,1823,1750,高雄市
2041,2020-06-06 17:43:24,9107,221,43.17,9328,57,9385,21094,44.49,1,1,24,24,鹽埕區
2042,2020-06-06 17:43:25,111643,2663,39.69,114306,527,114833,260604,44.06,1,0,189,177,三民區
2043,2020-06-06 17:43:25,57508,1416,36.37,58924,271,59195,158116,37.44,1,1,103,103,左營區
2044,2020-06-06 17:43:25,17452,443,40.21,17895,96,17991,43397,41.46,1,1,42,42,新興區
2045,2020-06-06 17:43:25,60061,1587,39.64,61648,277,61925,147664,41.94,1,0,99,97,楠梓區
2046,2020-06-06 17:43:25,41798,947,36.85,42745,175,42920,106570,40.27,1,0,77,73,鼓山區
2047,2020-06-06 17:43:26,66816,1779,42.48,68595,347,68942,157294,43.83,1,1,119,119,前鎮區
2048,2020-06-06 17:43:26,9437,252,39.81,9689,47,9736,23704,41.07,1,1,22,22,前金區
2049,2020-06-06 17:43:26,56469,1409,39.56,57878,294,58172,141250,41.18,1,0,116,115,苓雅區
2050,2020-06-06 17:43:27,15318,389,42.88,15707,89,15796,35719,44.22,1,1,32,32,大樹區
2051,2020-06-06 17:43:27,28967,737,30.5,29704,166,29870,70245,42.52,1,0,81,61,大寮區
2052,2020-06-06 17:43:27,32787,886,44.32,33673,168,33841,73973,45.75,1,1,47,47,仁武區
2053,2020-06-06 17:43:27,13320,363,45.49,13683,89,13772,29282,47.03,1,1,24,24,大社區
2054,2020-06-06 17:43:27,55361,1415,42.72,56776,259,57035,129597,44.01,1,1,89,89,小港區
2055,2020-06-06 17:43:27,25028,684,43.44,25712,194,25906,57617,44.96,1,1,51,51,林園區
2056,2020-06-06 17:43:27,16662,412,42.76,17074,91,17165,38963,44.05,1,1,28,28,鳥松區
2057,2020-06-06 17:43:27,97529,2536,33.16,100065,517,100582,245857,40.91,1,0,228,194,鳳山區
2058,2020-06-06 17:43:27,10658,295,44.49,10953,58,11011,23954,45.97,1,1,18,18,旗津區
2059,2020-06-06 17:43:28,18054,568,42.55,18622,111,18733,42432,44.15,1,1,41,41,路竹區
2060,2020-06-06 17:43:28,10600,315,41.54,10915,59,10974,25515,43.01,1,1,21,21,茄萣區
2061,2020-06-06 17:43:28,10929,369,43.55,11298,75,11373,25097,45.32,1,1,24,24,湖內區
2062,2020-06-06 17:43:28,16254,507,49.89,16761,95,16856,32578,51.74,1,1,31,31,橋頭區
2063,2020-06-06 17:43:28,10618,306,41.88,10924,91,11015,25354,43.44,1,1,25,25,燕巢區
2064,2020-06-06 17:43:28,2552,92,39.72,2644,21,2665,6425,41.48,1,1,12,12,田寮區
2065,2020-06-06 17:43:28,32084,895,40.55,32979,190,33169,79113,41.93,1,1,72,72,岡山區
2066,2020-06-06 17:43:28,10559,281,44.29,10840,70,10910,23841,45.76,1,1,21,21,阿蓮區
2067,2020-06-06 17:43:28,4914,122,42.0,5036,23,5059,11699,43.24,1,1,12,12,永安區
2068,2020-06-06 17:43:29,1223,56,23.41,1279,16,1295,5224,24.79,1,1,7,7,甲仙區
2069,2020-06-06 17:43:29,2733,121,26.69,2854,28,2882,10238,28.15,1,1,10,10,杉林區
2070,2020-06-06 17:43:29,14032,404,46.35,14436,87,14523,30272,47.98,1,1,28,28,梓官區
2071,2020-06-06 17:43:29,11399,474,37.0,11873,78,11951,30807,38.79,1,1,35,35,旗山區
2072,2020-06-06 17:43:29,6173,193,38.78,6366,48,6414,15918,40.29,1,1,18,18,彌陀區
2073,2020-06-06 17:43:29,60,1,3.95,61,0,61,1520,4.01,1,1,3,3,茂林區
2074,2020-06-06 17:43:29,9749,420,28.58,10169,88,10257,34112,30.07,1,1,32,32,美濃區
2075,2020-06-06 17:43:29,3863,145,30.86,4008,56,4064,12517,32.47,1,1,18,18,內門區
2076,2020-06-06 17:43:29,2880,164,26.41,3044,40,3084,10903,28.29,1,1,12,12,六龜區
2077,2020-06-06 17:43:30,209,7,8.95,216,0,216,2334,9.25,1,1,4,4,那瑪夏區
2078,2020-06-06 17:43:30,201,24,6.01,225,2,227,3342,6.79,1,1,8,8,桃源區
2079,2020-06-06 17:44:20,895007,23898,38.91,918905,4900,923805,2194141,42.1,38,32,1823,1750,高雄市
2080,2020-06-06 17:44:20,57508,1416,36.37,58924,271,59195,158116,37.44,1,1,103,103,左營區
2081,2020-06-06 17:44:20,60061,1587,39.64,61648,277,61925,147664,41.94,1,0,99,97,楠梓區
2082,2020-06-06 17:44:20,9107,221,43.17,9328,57,9385,21094,44.49,1,1,24,24,鹽埕區
2083,2020-06-06 17:44:20,41798,947,36.85,42745,175,42920,106570,40.27,1,0,77,73,鼓山區
2084,2020-06-06 17:44:21,17452,443,40.21,17895,96,17991,43397,41.46,1,1,42,42,新興區
2085,2020-06-06 17:44:21,111643,2663,39.69,114306,527,114833,260604,44.06,1,0,189,177,三民區
2086,2020-06-06 17:44:21,66816,1779,42.48,68595,347,68942,157294,43.83,1,1,119,119,前鎮區
2087,2020-06-06 17:44:21,28967,737,30.5,29704,166,29870,70245,42.52,1,0,81,61,大寮區
2088,2020-06-06 17:44:21,16662,412,42.76,17074,91,17165,38963,44.05,1,1,28,28,鳥松區
2089,2020-06-06 17:44:21,15318,389,42.88,15707,89,15796,35719,44.22,1,1,32,32,大樹區
2090,2020-06-06 17:44:21,13320,363,45.49,13683,89,13772,29282,47.03,1,1,24,24,大社區
2091,2020-06-06 17:44:21,56469,1409,39.56,57878,294,58172,141250,41.18,1,0,116,115,苓雅區
2092,2020-06-06 17:44:21,9437,252,39.81,9689,47,9736,23704,41.07,1,1,22,22,前金區
2093,2020-06-06 17:44:21,55361,1415,42.72,56776,259,57035,129597,44.01,1,1,89,89,小港區
2094,2020-06-06 17:44:21,97529,2536,33.16,100065,517,100582,245857,40.91,1,0,228,194,鳳山區
2095,2020-06-06 17:44:21,32787,886,44.32,33673,168,33841,73973,45.75,1,1,47,47,仁武區
2096,2020-06-06 17:44:21,10658,295,44.49,10953,58,11011,23954,45.97,1,1,18,18,旗津區
2097,2020-06-06 17:44:21,25028,684,43.44,25712,194,25906,57617,44.96,1,1,51,51,林園區
2098,2020-06-06 17:44:22,32084,895,40.55,32979,190,33169,79113,41.93,1,1,72,72,岡山區
2099,2020-06-06 17:44:22,16254,507,49.89,16761,95,16856,32578,51.74,1,1,31,31,橋頭區
2100,2020-06-06 17:44:23,4914,122,42.0,5036,23,5059,11699,43.24,1,1,12,12,永安區
2101,2020-06-06 17:44:23,18054,568,42.55,18622,111,18733,42432,44.15,1,1,41,41,路竹區
2102,2020-06-06 17:44:23,10559,281,44.29,10840,70,10910,23841,45.76,1,1,21,21,阿蓮區
2103,2020-06-06 17:44:23,2552,92,39.72,2644,21,2665,6425,41.48,1,1,12,12,田寮區
2104,2020-06-06 17:44:23,10600,315,41.54,10915,59,10974,25515,43.01,1,1,21,21,茄萣區
2105,2020-06-06 17:44:23,10929,369,43.55,11298,75,11373,25097,45.32,1,1,24,24,湖內區
2106,2020-06-06 17:44:23,10618,306,41.88,10924,91,11015,25354,43.44,1,1,25,25,燕巢區
2107,2020-06-06 17:44:24,1223,56,23.41,1279,16,1295,5224,24.79,1,1,7,7,甲仙區
2108,2020-06-06 17:44:24,6173,193,38.78,6366,48,6414,15918,40.29,1,1,18,18,彌陀區
2109,2020-06-06 17:44:24,9749,420,28.58,10169,88,10257,34112,30.07,1,1,32,32,美濃區
2110,2020-06-06 17:44:24,14032,404,46.35,14436,87,14523,30272,47.98,1,1,28,28,梓官區
2111,2020-06-06 17:44:24,2880,164,26.41,3044,40,3084,10903,28.29,1,1,12,12,六龜區
2112,2020-06-06 17:44:24,201,24,6.01,225,2,227,3342,6.79,1,1,8,8,桃源區
2113,2020-06-06 17:44:24,60,1,3.95,61,0,61,1520,4.01,1,1,3,3,茂林區
2114,2020-06-06 17:44:24,2733,121,26.69,2854,28,2882,10238,28.15,1,1,10,10,杉林區
2115,2020-06-06 17:44:24,11399,474,37.0,11873,78,11951,30807,38.79,1,1,35,35,旗山區
2116,2020-06-06 17:44:24,3863,145,30.86,4008,56,4064,12517,32.47,1,1,18,18,內門區
2117,2020-06-06 17:44:25,209,7,8.95,216,0,216,2334,9.25,1,1,4,4,那瑪夏區
2118,2020-06-06 17:45:15,60747,1607,40.09,62354,279,62633,149662,41.85,1,0,99,98,楠梓區
2119,2020-06-06 17:45:15,9107,221,43.17,9328,57,9385,21094,44.49,1,1,24,24,鹽埕區
2120,2020-06-06 17:45:15,902073,24087,39.22,926160,4924,931084,2211667,42.1,38,33,1823,1762,高雄市
2121,2020-06-06 17:45:15,57508,1416,36.37,58924,271,59195,158116,37.44,1,1,103,103,左營區
2122,2020-06-06 17:45:15,41798,947,36.85,42745,175,42920,106570,40.27,1,0,77,73,鼓山區
2123,2020-06-06 17:45:16,17452,443,40.21,17895,96,17991,43397,41.46,1,1,42,42,新興區
2124,2020-06-06 17:45:16,111643,2663,39.69,114306,527,114833,260604,44.06,1,0,189,177,三民區
2125,2020-06-06 17:45:16,57069,1421,39.98,58490,295,58785,142733,41.19,1,1,116,116,苓雅區
2126,2020-06-06 17:45:16,9437,252,39.81,9689,47,9736,23704,41.07,1,1,22,22,前金區
2127,2020-06-06 17:45:17,66816,1779,42.48,68595,347,68942,157294,43.83,1,1,119,119,前鎮區
2128,2020-06-06 17:45:17,10658,295,44.49,10953,58,11011,23954,45.97,1,1,18,18,旗津區
2129,2020-06-06 17:45:18,55361,1415,42.72,56776,259,57035,129597,44.01,1,1,89,89,小港區
2130,2020-06-06 17:45:18,101516,2640,34.52,104156,531,104687,255356,41.0,1,0,228,201,鳳山區
2131,2020-06-06 17:45:18,25028,684,43.44,25712,194,25906,57617,44.96,1,1,51,51,林園區
2132,2020-06-06 17:45:19,13320,363,45.49,13683,89,13772,29282,47.03,1,1,24,24,大社區
2133,2020-06-06 17:45:19,32787,886,44.32,33673,168,33841,73973,45.75,1,1,47,47,仁武區
2134,2020-06-06 17:45:19,15318,389,42.88,15707,89,15796,35719,44.22,1,1,32,32,大樹區
2135,2020-06-06 17:45:19,30760,790,32.38,31550,173,31723,74791,42.42,1,0,81,64,大寮區
2136,2020-06-06 17:45:20,16662,412,42.76,17074,91,17165,38963,44.05,1,1,28,28,鳥松區
2137,2020-06-06 17:45:20,16254,507,49.89,16761,95,16856,32578,51.74,1,1,31,31,橋頭區
2138,2020-06-06 17:45:20,32084,895,40.55,32979,190,33169,79113,41.93,1,1,72,72,岡山區
2139,2020-06-06 17:45:21,2552,92,39.72,2644,21,2665,6425,41.48,1,1,12,12,田寮區
2140,2020-06-06 17:45:21,10929,369,43.55,11298,75,11373,25097,45.32,1,1,24,24,湖內區
2141,2020-06-06 17:45:21,10559,281,44.29,10840,70,10910,23841,45.76,1,1,21,21,阿蓮區
2142,2020-06-06 17:45:21,18054,568,42.55,18622,111,18733,42432,44.15,1,1,41,41,路竹區
2143,2020-06-06 17:45:21,10618,306,41.88,10924,91,11015,25354,43.44,1,1,25,25,燕巢區
2144,2020-06-06 17:45:22,14032,404,46.35,14436,87,14523,30272,47.98,1,1,28,28,梓官區
2145,2020-06-06 17:45:22,2880,164,26.41,3044,40,3084,10903,28.29,1,1,12,12,六龜區
2146,2020-06-06 17:45:22,9749,420,28.58,10169,88,10257,34112,30.07,1,1,32,32,美濃區
2147,2020-06-06 17:45:22,6173,193,38.78,6366,48,6414,15918,40.29,1,1,18,18,彌陀區
2148,2020-06-06 17:45:22,1223,56,23.41,1279,16,1295,5224,24.79,1,1,7,7,甲仙區
2149,2020-06-06 17:45:22,11399,474,37.0,11873,78,11951,30807,38.79,1,1,35,35,旗山區
2150,2020-06-06 17:45:22,2733,121,26.69,2854,28,2882,10238,28.15,1,1,10,10,杉林區
2151,2020-06-06 17:45:22,10600,315,41.54,10915,59,10974,25515,43.01,1,1,21,21,茄萣區
2152,2020-06-06 17:45:22,4914,122,42.0,5036,23,5059,11699,43.24,1,1,12,12,永安區
2153,2020-06-06 17:45:23,60,1,3.95,61,0,61,1520,4.01,1,1,3,3,茂林區
2154,2020-06-06 17:45:23,3863,145,30.86,4008,56,4064,12517,32.47,1,1,18,18,內門區
2155,2020-06-06 17:45:23,201,24,6.01,225,2,227,3342,6.79,1,1,8,8,桃源區
2156,2020-06-06 17:45:23,209,7,8.95,216,0,216,2334,9.25,1,1,4,4,那瑪夏區
2157,2020-06-06 17:46:13,57508,1416,36.37,58924,271,59195,158116,37.44,1,1,103,103,左營區
2158,2020-06-06 17:46:13,9107,221,43.17,9328,57,9385,21094,44.49,1,1,24,24,鹽埕區
2159,2020-06-06 17:46:13,17452,443,40.21,17895,96,17991,43397,41.46,1,1,42,42,新興區
2160,2020-06-06 17:46:13,60747,1607,40.09,62354,279,62633,149662,41.85,1,0,99,98,楠梓區
2161,2020-06-06 17:46:13,111643,2663,39.69,114306,527,114833,260604,44.06,1,0,189,177,三民區
2162,2020-06-06 17:46:13,57069,1421,39.98,58490,295,58785,142733,41.19,1,1,116,116,苓雅區
2163,2020-06-06 17:46:13,41798,947,36.85,42745,175,42920,106570,40.27,1,0,77,73,鼓山區
2164,2020-06-06 17:46:13,902073,24087,39.22,926160,4924,931084,2211667,42.1,38,33,1823,1762,高雄市
2165,2020-06-06 17:46:13,9437,252,39.81,9689,47,9736,23704,41.07,1,1,22,22,前金區
2166,2020-06-06 17:46:14,13320,363,45.49,13683,89,13772,29282,47.03,1,1,24,24,大社區
2167,2020-06-06 17:46:14,10658,295,44.49,10953,58,11011,23954,45.97,1,1,18,18,旗津區
2168,2020-06-06 17:46:14,32084,895,40.55,32979,190,33169,79113,41.93,1,1,72,72,岡山區
2169,2020-06-06 17:46:14,25028,684,43.44,25712,194,25906,57617,44.96,1,1,51,51,林園區
2170,2020-06-06 17:46:14,30760,790,32.38,31550,173,31723,74791,42.42,1,0,81,64,大寮區
2171,2020-06-06 17:46:14,15318,389,42.88,15707,89,15796,35719,44.22,1,1,32,32,大樹區
2172,2020-06-06 17:46:14,16662,412,42.76,17074,91,17165,38963,44.05,1,1,28,28,鳥松區
2173,2020-06-06 17:46:14,101516,2640,34.52,104156,531,104687,255356,41.0,1,0,228,201,鳳山區
2174,2020-06-06 17:46:14,66816,1779,42.48,68595,347,68942,157294,43.83,1,1,119,119,前鎮區
2175,2020-06-06 17:46:14,55361,1415,42.72,56776,259,57035,129597,44.01,1,1,89,89,小港區
2176,2020-06-06 17:46:14,32787,886,44.32,33673,168,33841,73973,45.75,1,1,47,47,仁武區
2177,2020-06-06 17:46:15,18054,568,42.55,18622,111,18733,42432,44.15,1,1,41,41,路竹區
2178,2020-06-06 17:46:15,16254,507,49.89,16761,95,16856,32578,51.74,1,1,31,31,橋頭區
2179,2020-06-06 17:46:15,9749,420,28.58,10169,88,10257,34112,30.07,1,1,32,32,美濃區
2180,2020-06-06 17:46:15,6173,193,38.78,6366,48,6414,15918,40.29,1,1,18,18,彌陀區
2181,2020-06-06 17:46:15,2552,92,39.72,2644,21,2665,6425,41.48,1,1,12,12,田寮區
2182,2020-06-06 17:46:15,10618,306,41.88,10924,91,11015,25354,43.44,1,1,25,25,燕巢區
2183,2020-06-06 17:46:15,10929,369,43.55,11298,75,11373,25097,45.32,1,1,24,24,湖內區
2184,2020-06-06 17:46:15,2880,164,26.41,3044,40,3084,10903,28.29,1,1,12,12,六龜區
2185,2020-06-06 17:46:15,10600,315,41.54,10915,59,10974,25515,43.01,1,1,21,21,茄萣區
2186,2020-06-06 17:46:15,14032,404,46.35,14436,87,14523,30272,47.98,1,1,28,28,梓官區
2187,2020-06-06 17:46:15,1223,56,23.41,1279,16,1295,5224,24.79,1,1,7,7,甲仙區
2188,2020-06-06 17:46:15,11399,474,37.0,11873,78,11951,30807,38.79,1,1,35,35,旗山區
2189,2020-06-06 17:46:15,10559,281,44.29,10840,70,10910,23841,45.76,1,1,21,21,阿蓮區
2190,2020-06-06 17:46:15,4914,122,42.0,5036,23,5059,11699,43.24,1,1,12,12,永安區
2191,2020-06-06 17:46:16,209,7,8.95,216,0,216,2334,9.25,1,1,4,4,那瑪夏區
2192,2020-06-06 17:46:16,3863,145,30.86,4008,56,4064,12517,32.47,1,1,18,18,內門區
2193,2020-06-06 17:46:16,201,24,6.01,225,2,227,3342,6.79,1,1,8,8,桃源區
2194,2020-06-06 17:46:16,60,1,3.95,61,0,61,1520,4.01,1,1,3,3,茂林區
2195,2020-06-06 17:46:16,2733,121,26.69,2854,28,2882,10238,28.15,1,1,10,10,杉林區
2196,2020-06-06 17:47:06,57508,1416,36.37,58924,271,59195,158116,37.44,1,1,103,103,左營區
2197,2020-06-06 17:47:06,9107,221,43.17,9328,57,9385,21094,44.49,1,1,24,24,鹽埕區
2198,2020-06-06 17:47:06,41798,947,36.85,42745,175,42920,106570,40.27,1,0,77,73,鼓山區
2199,2020-06-06 17:47:06,902073,24087,39.22,926160,4924,931084,2211667,42.1,38,33,1823,1762,高雄市
2200,2020-06-06 17:47:07,60747,1607,40.09,62354,279,62633,149662,41.85,1,0,99,98,楠梓區
2201,2020-06-06 17:47:07,55361,1415,42.72,56776,259,57035,129597,44.01,1,1,89,89,小港區
2202,2020-06-06 17:47:07,17452,443,40.21,17895,96,17991,43397,41.46,1,1,42,42,新興區
2203,2020-06-06 17:47:07,9437,252,39.81,9689,47,9736,23704,41.07,1,1,22,22,前金區
2204,2020-06-06 17:47:07,66816,1779,42.48,68595,347,68942,157294,43.83,1,1,119,119,前鎮區
2205,2020-06-06 17:47:07,57069,1421,39.98,58490,295,58785,142733,41.19,1,1,116,116,苓雅區
2206,2020-06-06 17:47:07,10658,295,44.49,10953,58,11011,23954,45.97,1,1,18,18,旗津區
2207,2020-06-06 17:47:07,111643,2663,39.69,114306,527,114833,260604,44.06,1,0,189,177,三民區
2208,2020-06-06 17:47:08,30760,790,32.38,31550,173,31723,74791,42.42,1,0,81,64,大寮區
2209,2020-06-06 17:47:08,13320,363,45.49,13683,89,13772,29282,47.03,1,1,24,24,大社區
2210,2020-06-06 17:47:08,32787,886,44.32,33673,168,33841,73973,45.75,1,1,47,47,仁武區
2211,2020-06-06 17:47:08,101516,2640,34.52,104156,531,104687,255356,41.0,1,0,228,201,鳳山區
2212,2020-06-06 17:47:08,25028,684,43.44,25712,194,25906,57617,44.96,1,1,51,51,林園區
2213,2020-06-06 17:47:08,15318,389,42.88,15707,89,15796,35719,44.22,1,1,32,32,大樹區
2214,2020-06-06 17:47:09,10618,306,41.88,10924,91,11015,25354,43.44,1,1,25,25,燕巢區
2215,2020-06-06 17:47:09,16662,412,42.76,17074,91,17165,38963,44.05,1,1,28,28,鳥松區
2216,2020-06-06 17:47:09,16254,507,49.89,16761,95,16856,32578,51.74,1,1,31,31,橋頭區
2217,2020-06-06 17:47:09,32084,895,40.55,32979,190,33169,79113,41.93,1,1,72,72,岡山區
2218,2020-06-06 17:47:10,10929,369,43.55,11298,75,11373,25097,45.32,1,1,24,24,湖內區
2219,2020-06-06 17:47:10,10559,281,44.29,10840,70,10910,23841,45.76,1,1,21,21,阿蓮區
2220,2020-06-06 17:47:10,2552,92,39.72,2644,21,2665,6425,41.48,1,1,12,12,田寮區
2221,2020-06-06 17:47:10,18054,568,42.55,18622,111,18733,42432,44.15,1,1,41,41,路竹區
2222,2020-06-06 17:47:11,11399,474,37.0,11873,78,11951,30807,38.79,1,1,35,35,旗山區
2223,2020-06-06 17:47:11,14032,404,46.35,14436,87,14523,30272,47.98,1,1,28,28,梓官區
2224,2020-06-06 17:47:11,4914,122,42.0,5036,23,5059,11699,43.24,1,1,12,12,永安區
2225,2020-06-06 17:47:11,10600,315,41.54,10915,59,10974,25515,43.01,1,1,21,21,茄萣區
2226,2020-06-06 17:47:11,6173,193,38.78,6366,48,6414,15918,40.29,1,1,18,18,彌陀區
2227,2020-06-06 17:47:12,209,7,8.95,216,0,216,2334,9.25,1,1,4,4,那瑪夏區
2228,2020-06-06 17:47:12,60,1,3.95,61,0,61,1520,4.01,1,1,3,3,茂林區
2229,2020-06-06 17:47:12,2733,121,26.69,2854,28,2882,10238,28.15,1,1,10,10,杉林區
2230,2020-06-06 17:47:12,9749,420,28.58,10169,88,10257,34112,30.07,1,1,32,32,美濃區
2231,2020-06-06 17:47:12,2880,164,26.41,3044,40,3084,10903,28.29,1,1,12,12,六龜區
2232,2020-06-06 17:47:12,201,24,6.01,225,2,227,3342,6.79,1,1,8,8,桃源區
2233,2020-06-06 17:47:12,3863,145,30.86,4008,56,4064,12517,32.47,1,1,18,18,內門區
2234,2020-06-06 17:47:12,1223,56,23.41,1279,16,1295,5224,24.79,1,1,7,7,甲仙區
2235,2020-06-06 17:48:02,60747,1607,40.09,62354,279,62633,149662,41.85,1,0,99,98,楠梓區
2236,2020-06-06 17:48:02,57508,1416,36.37,58924,271,59195,158116,37.44,1,1,103,103,左營區
2237,2020-06-06 17:48:02,9107,221,43.17,9328,57,9385,21094,44.49,1,1,24,24,鹽埕區
2238,2020-06-06 17:48:02,41798,947,36.85,42745,175,42920,106570,40.27,1,0,77,73,鼓山區
2239,2020-06-06 17:48:02,902073,24087,39.22,926160,4924,931084,2211667,42.1,38,33,1823,1762,高雄市
2240,2020-06-06 17:48:03,10658,295,44.49,10953,58,11011,23954,45.97,1,1,18,18,旗津區
2241,2020-06-06 17:48:03,101516,2640,34.52,104156,531,104687,255356,41.0,1,0,228,201,鳳山區
2242,2020-06-06 17:48:03,111643,2663,39.69,114306,527,114833,260604,44.06,1,0,189,177,三民區
2243,2020-06-06 17:48:03,57069,1421,39.98,58490,295,58785,142733,41.19,1,1,116,116,苓雅區
2244,2020-06-06 17:48:03,55361,1415,42.72,56776,259,57035,129597,44.01,1,1,89,89,小港區
2245,2020-06-06 17:48:03,9437,252,39.81,9689,47,9736,23704,41.07,1,1,22,22,前金區
2246,2020-06-06 17:48:03,25028,684,43.44,25712,194,25906,57617,44.96,1,1,51,51,林園區
2247,2020-06-06 17:48:03,17452,443,40.21,17895,96,17991,43397,41.46,1,1,42,42,新興區
2248,2020-06-06 17:48:03,66816,1779,42.48,68595,347,68942,157294,43.83,1,1,119,119,前鎮區
2249,2020-06-06 17:48:04,15318,389,42.88,15707,89,15796,35719,44.22,1,1,32,32,大樹區
2250,2020-06-06 17:48:04,32787,886,44.32,33673,168,33841,73973,45.75,1,1,47,47,仁武區
2251,2020-06-06 17:48:04,30760,790,32.38,31550,173,31723,74791,42.42,1,0,81,64,大寮區
2252,2020-06-06 17:48:04,13320,363,45.49,13683,89,13772,29282,47.03,1,1,24,24,大社區
2253,2020-06-06 17:48:04,16662,412,42.76,17074,91,17165,38963,44.05,1,1,28,28,鳥松區
2254,2020-06-06 17:48:05,10618,306,41.88,10924,91,11015,25354,43.44,1,1,25,25,燕巢區
2255,2020-06-06 17:48:05,18054,568,42.55,18622,111,18733,42432,44.15,1,1,41,41,路竹區
2256,2020-06-06 17:48:05,2552,92,39.72,2644,21,2665,6425,41.48,1,1,12,12,田寮區
2257,2020-06-06 17:48:05,10559,281,44.29,10840,70,10910,23841,45.76,1,1,21,21,阿蓮區
2258,2020-06-06 17:48:05,32084,895,40.55,32979,190,33169,79113,41.93,1,1,72,72,岡山區
2259,2020-06-06 17:48:05,16254,507,49.89,16761,95,16856,32578,51.74,1,1,31,31,橋頭區
2260,2020-06-06 17:48:05,10600,315,41.54,10915,59,10974,25515,43.01,1,1,21,21,茄萣區
2261,2020-06-06 17:48:05,10929,369,43.55,11298,75,11373,25097,45.32,1,1,24,24,湖內區
2262,2020-06-06 17:48:06,4914,122,42.0,5036,23,5059,11699,43.24,1,1,12,12,永安區
2263,2020-06-06 17:48:06,6173,193,38.78,6366,48,6414,15918,40.29,1,1,18,18,彌陀區
2264,2020-06-06 17:48:06,14032,404,46.35,14436,87,14523,30272,47.98,1,1,28,28,梓官區
2265,2020-06-06 17:48:06,11399,474,37.0,11873,78,11951,30807,38.79,1,1,35,35,旗山區
2266,2020-06-06 17:48:07,1223,56,23.41,1279,16,1295,5224,24.79,1,1,7,7,甲仙區
2267,2020-06-06 17:48:07,3863,145,30.86,4008,56,4064,12517,32.47,1,1,18,18,內門區
2268,2020-06-06 17:48:07,2733,121,26.69,2854,28,2882,10238,28.15,1,1,10,10,杉林區
2269,2020-06-06 17:48:07,2880,164,26.41,3044,40,3084,10903,28.29,1,1,12,12,六龜區
2270,2020-06-06 17:48:07,9749,420,28.58,10169,88,10257,34112,30.07,1,1,32,32,美濃區
2271,2020-06-06 17:48:08,201,24,6.01,225,2,227,3342,6.79,1,1,8,8,桃源區
2272,2020-06-06 17:48:08,209,7,8.95,216,0,216,2334,9.25,1,1,4,4,那瑪夏區
2273,2020-06-06 17:48:08,60,1,3.95,61,0,61,1520,4.01,1,1,3,3,茂林區
2274,2020-06-06 17:48:58,60747,1607,40.09,62354,279,62633,149662,41.85,1,0,99,98,楠梓區
2275,2020-06-06 17:48:58,57508,1416,36.37,58924,271,59195,158116,37.44,1,1,103,103,左營區
2276,2020-06-06 17:48:58,9107,221,43.17,9328,57,9385,21094,44.49,1,1,24,24,鹽埕區
2277,2020-06-06 17:48:58,42357,960,37.34,43317,176,43493,107714,40.38,1,0,77,74,鼓山區
2278,2020-06-06 17:48:58,910564,24295,39.59,934859,4971,939830,2231713,42.11,38,33,1823,1777,高雄市
2279,2020-06-06 17:48:59,66816,1779,42.48,68595,347,68942,157294,43.83,1,1,119,119,前鎮區
2280,2020-06-06 17:48:59,17452,443,40.21,17895,96,17991,43397,41.46,1,1,42,42,新興區
2281,2020-06-06 17:48:59,13320,363,45.49,13683,89,13772,29282,47.03,1,1,24,24,大社區
2282,2020-06-06 17:48:59,57069,1421,39.98,58490,295,58785,142733,41.19,1,1,116,116,苓雅區
2283,2020-06-06 17:48:59,107419,2768,36.53,110187,563,110750,269225,41.14,1,0,228,211,鳳山區
2284,2020-06-06 17:48:59,10658,295,44.49,10953,58,11011,23954,45.97,1,1,18,18,旗津區
2285,2020-06-06 17:48:59,15318,389,42.88,15707,89,15796,35719,44.22,1,1,32,32,大樹區
2286,2020-06-06 17:48:59,16662,412,42.76,17074,91,17165,38963,44.05,1,1,28,28,鳥松區
2287,2020-06-06 17:48:59,9437,252,39.81,9689,47,9736,23704,41.07,1,1,22,22,前金區
2288,2020-06-06 17:48:59,112212,2677,39.89,114889,529,115418,262003,44.05,1,0,189,178,三民區
2289,2020-06-06 17:48:59,32787,886,44.32,33673,168,33841,73973,45.75,1,1,47,47,仁武區
2290,2020-06-06 17:48:59,32220,843,33.92,33063,185,33248,78425,42.39,1,0,81,67,大寮區
2291,2020-06-06 17:48:59,25028,684,43.44,25712,194,25906,57617,44.96,1,1,51,51,林園區
2292,2020-06-06 17:48:59,55361,1415,42.72,56776,259,57035,129597,44.01,1,1,89,89,小港區
2293,2020-06-06 17:49:00,32084,895,40.55,32979,190,33169,79113,41.93,1,1,72,72,岡山區
2294,2020-06-06 17:49:00,2552,92,39.72,2644,21,2665,6425,41.48,1,1,12,12,田寮區
2295,2020-06-06 17:49:00,14032,404,46.35,14436,87,14523,30272,47.98,1,1,28,28,梓官區
2296,2020-06-06 17:49:00,6173,193,38.78,6366,48,6414,15918,40.29,1,1,18,18,彌陀區
2297,2020-06-06 17:49:00,10559,281,44.29,10840,70,10910,23841,45.76,1,1,21,21,阿蓮區
2298,2020-06-06 17:49:00,10600,315,41.54,10915,59,10974,25515,43.01,1,1,21,21,茄萣區
2299,2020-06-06 17:49:00,10929,369,43.55,11298,75,11373,25097,45.32,1,1,24,24,湖內區
2300,2020-06-06 17:49:00,18054,568,42.55,18622,111,18733,42432,44.15,1,1,41,41,路竹區
2301,2020-06-06 17:49:00,4914,122,42.0,5036,23,5059,11699,43.24,1,1,12,12,永安區
2302,2020-06-06 17:49:00,16254,507,49.89,16761,95,16856,32578,51.74,1,1,31,31,橋頭區
2303,2020-06-06 17:49:00,10618,306,41.88,10924,91,11015,25354,43.44,1,1,25,25,燕巢區
2304,2020-06-06 17:49:01,2880,164,26.41,3044,40,3084,10903,28.29,1,1,12,12,六龜區
2305,2020-06-06 17:49:01,11399,474,37.0,11873,78,11951,30807,38.79,1,1,35,35,旗山區
2306,2020-06-06 17:49:01,201,24,6.01,225,2,227,3342,6.79,1,1,8,8,桃源區
2307,2020-06-06 17:49:01,9749,420,28.58,10169,88,10257,34112,30.07,1,1,32,32,美濃區
2308,2020-06-06 17:49:01,3863,145,30.86,4008,56,4064,12517,32.47,1,1,18,18,內門區
2309,2020-06-06 17:49:01,60,1,3.95,61,0,61,1520,4.01,1,1,3,3,茂林區
2310,2020-06-06 17:49:01,2733,121,26.69,2854,28,2882,10238,28.15,1,1,10,10,杉林區
2311,2020-06-06 17:49:01,1223,56,23.41,1279,16,1295,5224,24.79,1,1,7,7,甲仙區
2312,2020-06-06 17:49:02,209,7,8.95,216,0,216,2334,9.25,1,1,4,4,那瑪夏區
2313,2020-06-06 17:49:52,112212,2677,39.89,114889,529,115418,262003,44.05,1,0,189,178,三民區
2314,2020-06-06 17:49:52,66816,1779,42.48,68595,347,68942,157294,43.83,1,1,119,119,前鎮區
2315,2020-06-06 17:49:52,42357,960,37.34,43317,176,43493,107714,40.38,1,0,77,74,鼓山區
2316,2020-06-06 17:49:52,910564,24295,39.59,934859,4971,939830,2231713,42.11,38,33,1823,1777,高雄市
2317,2020-06-06 17:49:52,9437,252,39.81,9689,47,9736,23704,41.07,1,1,22,22,前金區
2318,2020-06-06 17:49:52,60747,1607,40.09,62354,279,62633,149662,41.85,1,0,99,98,楠梓區
2319,2020-06-06 17:49:52,9107,221,43.17,9328,57,9385,21094,44.49,1,1,24,24,鹽埕區
2320,2020-06-06 17:49:52,17452,443,40.21,17895,96,17991,43397,41.46,1,1,42,42,新興區
2321,2020-06-06 17:49:52,57508,1416,36.37,58924,271,59195,158116,37.44,1,1,103,103,左營區
2322,2020-06-06 17:49:52,57069,1421,39.98,58490,295,58785,142733,41.19,1,1,116,116,苓雅區
2323,2020-06-06 17:49:53,25028,684,43.44,25712,194,25906,57617,44.96,1,1,51,51,林園區
2324,2020-06-06 17:49:53,10658,295,44.49,10953,58,11011,23954,45.97,1,1,18,18,旗津區
2325,2020-06-06 17:49:53,107419,2768,36.53,110187,563,110750,269225,41.14,1,0,228,211,鳳山區
2326,2020-06-06 17:49:53,55361,1415,42.72,56776,259,57035,129597,44.01,1,1,89,89,小港區
2327,2020-06-06 17:49:53,13320,363,45.49,13683,89,13772,29282,47.03,1,1,24,24,大社區
2328,2020-06-06 17:49:53,32787,886,44.32,33673,168,33841,73973,45.75,1,1,47,47,仁武區
2329,2020-06-06 17:49:53,32220,843,33.92,33063,185,33248,78425,42.39,1,0,81,67,大寮區
2330,2020-06-06 17:49:53,15318,389,42.88,15707,89,15796,35719,44.22,1,1,32,32,大樹區
2331,2020-06-06 17:49:54,2552,92,39.72,2644,21,2665,6425,41.48,1,1,12,12,田寮區
2332,2020-06-06 17:49:54,10929,369,43.55,11298,75,11373,25097,45.32,1,1,24,24,湖內區
2333,2020-06-06 17:49:54,16662,412,42.76,17074,91,17165,38963,44.05,1,1,28,28,鳥松區
2334,2020-06-06 17:49:54,32084,895,40.55,32979,190,33169,79113,41.93,1,1,72,72,岡山區
2335,2020-06-06 17:49:54,16254,507,49.89,16761,95,16856,32578,51.74,1,1,31,31,橋頭區
2336,2020-06-06 17:49:54,10600,315,41.54,10915,59,10974,25515,43.01,1,1,21,21,茄萣區
2337,2020-06-06 17:49:54,10618,306,41.88,10924,91,11015,25354,43.44,1,1,25,25,燕巢區
2338,2020-06-06 17:49:54,10559,281,44.29,10840,70,10910,23841,45.76,1,1,21,21,阿蓮區
2339,2020-06-06 17:49:54,18054,568,42.55,18622,111,18733,42432,44.15,1,1,41,41,路竹區
2340,2020-06-06 17:49:55,9749,420,28.58,10169,88,10257,34112,30.07,1,1,32,32,美濃區
2341,2020-06-06 17:49:55,11399,474,37.0,11873,78,11951,30807,38.79,1,1,35,35,旗山區
2342,2020-06-06 17:49:55,6173,193,38.78,6366,48,6414,15918,40.29,1,1,18,18,彌陀區
2343,2020-06-06 17:49:55,4914,122,42.0,5036,23,5059,11699,43.24,1,1,12,12,永安區
2344,2020-06-06 17:49:55,14032,404,46.35,14436,87,14523,30272,47.98,1,1,28,28,梓官區
2345,2020-06-06 17:49:55,2880,164,26.41,3044,40,3084,10903,28.29,1,1,12,12,六龜區
2346,2020-06-06 17:49:56,60,1,3.95,61,0,61,1520,4.01,1,1,3,3,茂林區
2347,2020-06-06 17:49:56,2733,121,26.69,2854,28,2882,10238,28.15,1,1,10,10,杉林區
2348,2020-06-06 17:49:56,201,24,6.01,225,2,227,3342,6.79,1,1,8,8,桃源區
2349,2020-06-06 17:49:56,1223,56,23.41,1279,16,1295,5224,24.79,1,1,7,7,甲仙區
2350,2020-06-06 17:49:56,3863,145,30.86,4008,56,4064,12517,32.47,1,1,18,18,內門區
2351,2020-06-06 17:49:57,209,7,8.95,216,0,216,2334,9.25,1,1,4,4,那瑪夏區
2352,2020-06-06 17:50:47,910564,24295,39.59,934859,4971,939830,2231713,42.11,38,33,1823,1777,高雄市
2353,2020-06-06 17:50:47,57508,1416,36.37,58924,271,59195,158116,37.44,1,1,103,103,左營區
2354,2020-06-06 17:50:47,9107,221,43.17,9328,57,9385,21094,44.49,1,1,24,24,鹽埕區
2355,2020-06-06 17:50:47,42357,960,37.34,43317,176,43493,107714,40.38,1,0,77,74,鼓山區
2356,2020-06-06 17:50:47,112212,2677,39.89,114889,529,115418,262003,44.05,1,0,189,178,三民區
2357,2020-06-06 17:50:47,60747,1607,40.09,62354,279,62633,149662,41.85,1,0,99,98,楠梓區
2358,2020-06-06 17:50:48,17452,443,40.21,17895,96,17991,43397,41.46,1,1,42,42,新興區
2359,2020-06-06 17:50:48,10658,295,44.49,10953,58,11011,23954,45.97,1,1,18,18,旗津區
2360,2020-06-06 17:50:48,55361,1415,42.72,56776,259,57035,129597,44.01,1,1,89,89,小港區
2361,2020-06-06 17:50:48,107419,2768,36.53,110187,563,110750,269225,41.14,1,0,228,211,鳳山區
2362,2020-06-06 17:50:48,57069,1421,39.98,58490,295,58785,142733,41.19,1,1,116,116,苓雅區
2363,2020-06-06 17:50:48,9437,252,39.81,9689,47,9736,23704,41.07,1,1,22,22,前金區
2364,2020-06-06 17:50:48,66816,1779,42.48,68595,347,68942,157294,43.83,1,1,119,119,前鎮區
2365,2020-06-06 17:50:49,15318,389,42.88,15707,89,15796,35719,44.22,1,1,32,32,大樹區
2366,2020-06-06 17:50:49,13320,363,45.49,13683,89,13772,29282,47.03,1,1,24,24,大社區
2367,2020-06-06 17:50:49,32787,886,44.32,33673,168,33841,73973,45.75,1,1,47,47,仁武區
2368,2020-06-06 17:50:49,16662,412,42.76,17074,91,17165,38963,44.05,1,1,28,28,鳥松區
2369,2020-06-06 17:50:49,32220,843,33.92,33063,185,33248,78425,42.39,1,0,81,67,大寮區
2370,2020-06-06 17:50:49,25028,684,43.44,25712,194,25906,57617,44.96,1,1,51,51,林園區
2371,2020-06-06 17:50:50,16254,507,49.89,16761,95,16856,32578,51.74,1,1,31,31,橋頭區
2372,2020-06-06 17:50:50,10559,281,44.29,10840,70,10910,23841,45.76,1,1,21,21,阿蓮區
2373,2020-06-06 17:50:50,18054,568,42.55,18622,111,18733,42432,44.15,1,1,41,41,路竹區
2374,2020-06-06 17:50:50,32084,895,40.55,32979,190,33169,79113,41.93,1,1,72,72,岡山區
2375,2020-06-06 17:50:50,2552,92,39.72,2644,21,2665,6425,41.48,1,1,12,12,田寮區
2376,2020-06-06 17:50:50,10618,306,41.88,10924,91,11015,25354,43.44,1,1,25,25,燕巢區
2377,2020-06-06 17:50:51,10929,369,43.55,11298,75,11373,25097,45.32,1,1,24,24,湖內區
2378,2020-06-06 17:50:51,6173,193,38.78,6366,48,6414,15918,40.29,1,1,18,18,彌陀區
2379,2020-06-06 17:50:51,11399,474,37.0,11873,78,11951,30807,38.79,1,1,35,35,旗山區
2380,2020-06-06 17:50:51,10600,315,41.54,10915,59,10974,25515,43.01,1,1,21,21,茄萣區
2381,2020-06-06 17:50:51,14032,404,46.35,14436,87,14523,30272,47.98,1,1,28,28,梓官區
2382,2020-06-06 17:50:51,4914,122,42.0,5036,23,5059,11699,43.24,1,1,12,12,永安區
2383,2020-06-06 17:50:51,9749,420,28.58,10169,88,10257,34112,30.07,1,1,32,32,美濃區
2384,2020-06-06 17:50:52,201,24,6.01,225,2,227,3342,6.79,1,1,8,8,桃源區
2385,2020-06-06 17:50:52,2880,164,26.41,3044,40,3084,10903,28.29,1,1,12,12,六龜區
2386,2020-06-06 17:50:52,60,1,3.95,61,0,61,1520,4.01,1,1,3,3,茂林區
2387,2020-06-06 17:50:52,1223,56,23.41,1279,16,1295,5224,24.79,1,1,7,7,甲仙區
2388,2020-06-06 17:50:52,3863,145,30.86,4008,56,4064,12517,32.47,1,1,18,18,內門區
2389,2020-06-06 17:50:52,2733,121,26.69,2854,28,2882,10238,28.15,1,1,10,10,杉林區
2390,2020-06-06 17:50:52,209,7,8.95,216,0,216,2334,9.25,1,1,4,4,那瑪夏區
2391,2020-06-06 17:51:42,57508,1416,36.37,58924,271,59195,158116,37.44,1,1,103,103,左營區
2392,2020-06-06 17:51:42,42357,960,37.34,43317,176,43493,107714,40.38,1,0,77,74,鼓山區
2393,2020-06-06 17:51:42,917917,24502,39.91,942419,5005,947424,2249574,42.12,38,33,1823,1789,高雄市
2394,2020-06-06 17:51:42,60747,1607,40.09,62354,279,62633,149662,41.85,1,0,99,98,楠梓區
2395,2020-06-06 17:51:42,9107,221,43.17,9328,57,9385,21094,44.49,1,1,24,24,鹽埕區
2396,2020-06-06 17:51:43,10658,295,44.49,10953,58,11011,23954,45.97,1,1,18,18,旗津區
2397,2020-06-06 17:51:43,15318,389,42.88,15707,89,15796,35719,44.22,1,1,32,32,大樹區
2398,2020-06-06 17:51:43,55361,1415,42.72,56776,259,57035,129597,44.01,1,1,89,89,小港區
2399,2020-06-06 17:51:43,57069,1421,39.98,58490,295,58785,142733,41.19,1,1,116,116,苓雅區
2400,2020-06-06 17:51:43,115168,2755,40.94,117923,543,118466,269335,43.98,1,0,189,182,三民區
2401,2020-06-06 17:51:43,66816,1779,42.48,68595,347,68942,157294,43.83,1,1,119,119,前鎮區
2402,2020-06-06 17:51:43,111028,2872,37.75,113900,580,114480,278034,41.17,1,0,228,217,鳳山區
2403,2020-06-06 17:51:43,25028,684,43.44,25712,194,25906,57617,44.96,1,1,51,51,林園區
2404,2020-06-06 17:51:43,9437,252,39.81,9689,47,9736,23704,41.07,1,1,22,22,前金區
2405,2020-06-06 17:51:43,17452,443,40.21,17895,96,17991,43397,41.46,1,1,42,42,新興區
2406,2020-06-06 17:51:43,33008,868,34.75,33876,188,34064,80145,42.5,1,0,81,69,大寮區
2407,2020-06-06 17:51:44,16662,412,42.76,17074,91,17165,38963,44.05,1,1,28,28,鳥松區
2408,2020-06-06 17:51:44,13320,363,45.49,13683,89,13772,29282,47.03,1,1,24,24,大社區
2409,2020-06-06 17:51:44,16254,507,49.89,16761,95,16856,32578,51.74,1,1,31,31,橋頭區
2410,2020-06-06 17:51:44,10559,281,44.29,10840,70,10910,23841,45.76,1,1,21,21,阿蓮區
2411,2020-06-06 17:51:44,32084,895,40.55,32979,190,33169,79113,41.93,1,1,72,72,岡山區
2412,2020-06-06 17:51:44,2552,92,39.72,2644,21,2665,6425,41.48,1,1,12,12,田寮區
2413,2020-06-06 17:51:44,10618,306,41.88,10924,91,11015,25354,43.44,1,1,25,25,燕巢區
2414,2020-06-06 17:51:44,18054,568,42.55,18622,111,18733,42432,44.15,1,1,41,41,路竹區
2415,2020-06-06 17:51:44,10600,315,41.54,10915,59,10974,25515,43.01,1,1,21,21,茄萣區
2416,2020-06-06 17:51:44,32787,886,44.32,33673,168,33841,73973,45.75,1,1,47,47,仁武區
2417,2020-06-06 17:51:44,10929,369,43.55,11298,75,11373,25097,45.32,1,1,24,24,湖內區
2418,2020-06-06 17:51:45,209,7,8.95,216,0,216,2334,9.25,1,1,4,4,那瑪夏區
2419,2020-06-06 17:51:45,4914,122,42.0,5036,23,5059,11699,43.24,1,1,12,12,永安區
2420,2020-06-06 17:51:45,1223,56,23.41,1279,16,1295,5224,24.79,1,1,7,7,甲仙區
2421,2020-06-06 17:51:45,9749,420,28.58,10169,88,10257,34112,30.07,1,1,32,32,美濃區
2422,2020-06-06 17:51:45,60,1,3.95,61,0,61,1520,4.01,1,1,3,3,茂林區
2423,2020-06-06 17:51:45,3863,145,30.86,4008,56,4064,12517,32.47,1,1,18,18,內門區
2424,2020-06-06 17:51:45,6173,193,38.78,6366,48,6414,15918,40.29,1,1,18,18,彌陀區
2425,2020-06-06 17:51:45,11399,474,37.0,11873,78,11951,30807,38.79,1,1,35,35,旗山區
2426,2020-06-06 17:51:45,2733,121,26.69,2854,28,2882,10238,28.15,1,1,10,10,杉林區
2427,2020-06-06 17:51:45,14032,404,46.35,14436,87,14523,30272,47.98,1,1,28,28,梓官區
2428,2020-06-06 17:51:45,2880,164,26.41,3044,40,3084,10903,28.29,1,1,12,12,六龜區
2429,2020-06-06 17:51:45,201,24,6.01,225,2,227,3342,6.79,1,1,8,8,桃源區
2430,2020-06-06 17:52:36,60747,1607,40.09,62354,279,62633,149662,41.85,1,0,99,98,楠梓區
2431,2020-06-06 17:52:36,42357,960,37.34,43317,176,43493,107714,40.38,1,0,77,74,鼓山區
2432,2020-06-06 17:52:36,115168,2755,40.94,117923,543,118466,269335,43.98,1,0,189,182,三民區
2433,2020-06-06 17:52:36,917917,24502,39.91,942419,5005,947424,2249574,42.12,38,33,1823,1789,高雄市
2434,2020-06-06 17:52:36,9107,221,43.17,9328,57,9385,21094,44.49,1,1,24,24,鹽埕區
2435,2020-06-06 17:52:36,17452,443,40.21,17895,96,17991,43397,41.46,1,1,42,42,新興區
2436,2020-06-06 17:52:36,57508,1416,36.37,58924,271,59195,158116,37.44,1,1,103,103,左營區
2437,2020-06-06 17:52:37,9437,252,39.81,9689,47,9736,23704,41.07,1,1,22,22,前金區
2438,2020-06-06 17:52:37,55361,1415,42.72,56776,259,57035,129597,44.01,1,1,89,89,小港區
2439,2020-06-06 17:52:37,111028,2872,37.75,113900,580,114480,278034,41.17,1,0,228,217,鳳山區
2440,2020-06-06 17:52:37,33008,868,34.75,33876,188,34064,80145,42.5,1,0,81,69,大寮區
2441,2020-06-06 17:52:37,32787,886,44.32,33673,168,33841,73973,45.75,1,1,47,47,仁武區
2442,2020-06-06 17:52:37,57069,1421,39.98,58490,295,58785,142733,41.19,1,1,116,116,苓雅區
2443,2020-06-06 17:52:37,15318,389,42.88,15707,89,15796,35719,44.22,1,1,32,32,大樹區
2444,2020-06-06 17:52:37,13320,363,45.49,13683,89,13772,29282,47.03,1,1,24,24,大社區
2445,2020-06-06 17:52:37,16662,412,42.76,17074,91,17165,38963,44.05,1,1,28,28,鳥松區
2446,2020-06-06 17:52:37,10658,295,44.49,10953,58,11011,23954,45.97,1,1,18,18,旗津區
2447,2020-06-06 17:52:37,66816,1779,42.48,68595,347,68942,157294,43.83,1,1,119,119,前鎮區
2448,2020-06-06 17:52:37,25028,684,43.44,25712,194,25906,57617,44.96,1,1,51,51,林園區
2449,2020-06-06 17:52:38,6173,193,38.78,6366,48,6414,15918,40.29,1,1,18,18,彌陀區
2450,2020-06-06 17:52:38,18054,568,42.55,18622,111,18733,42432,44.15,1,1,41,41,路竹區
2451,2020-06-06 17:52:38,4914,122,42.0,5036,23,5059,11699,43.24,1,1,12,12,永安區
2452,2020-06-06 17:52:38,10618,306,41.88,10924,91,11015,25354,43.44,1,1,25,25,燕巢區
2453,2020-06-06 17:52:38,10559,281,44.29,10840,70,10910,23841,45.76,1,1,21,21,阿蓮區
2454,2020-06-06 17:52:38,32084,895,40.55,32979,190,33169,79113,41.93,1,1,72,72,岡山區
2455,2020-06-06 17:52:38,2552,92,39.72,2644,21,2665,6425,41.48,1,1,12,12,田寮區
2456,2020-06-06 17:52:38,16254,507,49.89,16761,95,16856,32578,51.74,1,1,31,31,橋頭區
2457,2020-06-06 17:52:38,10929,369,43.55,11298,75,11373,25097,45.32,1,1,24,24,湖內區
2458,2020-06-06 17:52:38,10600,315,41.54,10915,59,10974,25515,43.01,1,1,21,21,茄萣區
2459,2020-06-06 17:52:39,1223,56,23.41,1279,16,1295,5224,24.79,1,1,7,7,甲仙區
2460,2020-06-06 17:52:39,2733,121,26.69,2854,28,2882,10238,28.15,1,1,10,10,杉林區
2461,2020-06-06 17:52:39,3863,145,30.86,4008,56,4064,12517,32.47,1,1,18,18,內門區
2462,2020-06-06 17:52:39,2880,164,26.41,3044,40,3084,10903,28.29,1,1,12,12,六龜區
2463,2020-06-06 17:52:39,11399,474,37.0,11873,78,11951,30807,38.79,1,1,35,35,旗山區
2464,2020-06-06 17:52:39,9749,420,28.58,10169,88,10257,34112,30.07,1,1,32,32,美濃區
2465,2020-06-06 17:52:39,60,1,3.95,61,0,61,1520,4.01,1,1,3,3,茂林區
2466,2020-06-06 17:52:39,14032,404,46.35,14436,87,14523,30272,47.98,1,1,28,28,梓官區
2467,2020-06-06 17:52:40,209,7,8.95,216,0,216,2334,9.25,1,1,4,4,那瑪夏區
2468,2020-06-06 17:52:40,201,24,6.01,225,2,227,3342,6.79,1,1,8,8,桃源區
2469,2020-06-06 17:53:30,42357,960,37.34,43317,176,43493,107714,40.38,1,0,77,74,鼓山區
2470,2020-06-06 17:53:30,917917,24502,39.91,942419,5005,947424,2249574,42.12,38,33,1823,1789,高雄市
2471,2020-06-06 17:53:30,60747,1607,40.09,62354,279,62633,149662,41.85,1,0,99,98,楠梓區
2472,2020-06-06 17:53:30,57508,1416,36.37,58924,271,59195,158116,37.44,1,1,103,103,左營區
2473,2020-06-06 17:53:30,9107,221,43.17,9328,57,9385,21094,44.49,1,1,24,24,鹽埕區
2474,2020-06-06 17:53:30,115168,2755,40.94,117923,543,118466,269335,43.98,1,0,189,182,三民區
2475,2020-06-06 17:53:30,17452,443,40.21,17895,96,17991,43397,41.46,1,1,42,42,新興區
2476,2020-06-06 17:53:31,13320,363,45.49,13683,89,13772,29282,47.03,1,1,24,24,大社區
2477,2020-06-06 17:53:31,2552,92,39.72,2644,21,2665,6425,41.48,1,1,12,12,田寮區
2478,2020-06-06 17:53:31,111028,2872,37.75,113900,580,114480,278034,41.17,1,0,228,217,鳳山區
2479,2020-06-06 17:53:31,32787,886,44.32,33673,168,33841,73973,45.75,1,1,47,47,仁武區
2480,2020-06-06 17:53:31,15318,389,42.88,15707,89,15796,35719,44.22,1,1,32,32,大樹區
2481,2020-06-06 17:53:31,25028,684,43.44,25712,194,25906,57617,44.96,1,1,51,51,林園區
2482,2020-06-06 17:53:31,16662,412,42.76,17074,91,17165,38963,44.05,1,1,28,28,鳥松區
2483,2020-06-06 17:53:31,57069,1421,39.98,58490,295,58785,142733,41.19,1,1,116,116,苓雅區
2484,2020-06-06 17:53:31,10658,295,44.49,10953,58,11011,23954,45.97,1,1,18,18,旗津區
2485,2020-06-06 17:53:31,16254,507,49.89,16761,95,16856,32578,51.74,1,1,31,31,橋頭區
2486,2020-06-06 17:53:31,9437,252,39.81,9689,47,9736,23704,41.07,1,1,22,22,前金區
2487,2020-06-06 17:53:31,66816,1779,42.48,68595,347,68942,157294,43.83,1,1,119,119,前鎮區
2488,2020-06-06 17:53:31,33008,868,34.75,33876,188,34064,80145,42.5,1,0,81,69,大寮區
2489,2020-06-06 17:53:31,10618,306,41.88,10924,91,11015,25354,43.44,1,1,25,25,燕巢區
2490,2020-06-06 17:53:31,32084,895,40.55,32979,190,33169,79113,41.93,1,1,72,72,岡山區
2491,2020-06-06 17:53:31,55361,1415,42.72,56776,259,57035,129597,44.01,1,1,89,89,小港區
2492,2020-06-06 17:53:32,6173,193,38.78,6366,48,6414,15918,40.29,1,1,18,18,彌陀區
2493,2020-06-06 17:53:32,4914,122,42.0,5036,23,5059,11699,43.24,1,1,12,12,永安區
2494,2020-06-06 17:53:32,10600,315,41.54,10915,59,10974,25515,43.01,1,1,21,21,茄萣區
2495,2020-06-06 17:53:32,14032,404,46.35,14436,87,14523,30272,47.98,1,1,28,28,梓官區
2496,2020-06-06 17:53:32,18054,568,42.55,18622,111,18733,42432,44.15,1,1,41,41,路竹區
2497,2020-06-06 17:53:32,10929,369,43.55,11298,75,11373,25097,45.32,1,1,24,24,湖內區
2498,2020-06-06 17:53:32,10559,281,44.29,10840,70,10910,23841,45.76,1,1,21,21,阿蓮區
2499,2020-06-06 17:53:33,9749,420,28.58,10169,88,10257,34112,30.07,1,1,32,32,美濃區
2500,2020-06-06 17:53:33,2880,164,26.41,3044,40,3084,10903,28.29,1,1,12,12,六龜區
2501,2020-06-06 17:53:33,11399,474,37.0,11873,78,11951,30807,38.79,1,1,35,35,旗山區
2502,2020-06-06 17:53:33,201,24,6.01,225,2,227,3342,6.79,1,1,8,8,桃源區
2503,2020-06-06 17:53:33,1223,56,23.41,1279,16,1295,5224,24.79,1,1,7,7,甲仙區
2504,2020-06-06 17:53:33,2733,121,26.69,2854,28,2882,10238,28.15,1,1,10,10,杉林區
2505,2020-06-06 17:53:33,209,7,8.95,216,0,216,2334,9.25,1,1,4,4,那瑪夏區
2506,2020-06-06 17:53:33,60,1,3.95,61,0,61,1520,4.01,1,1,3,3,茂林區
2507,2020-06-06 17:53:33,3863,145,30.86,4008,56,4064,12517,32.47,1,1,18,18,內門區
2508,2020-06-06 17:54:24,9107,221,43.17,9328,57,9385,21094,44.49,1,1,24,24,鹽埕區
2509,2020-06-06 17:54:24,922191,24612,40.1,946803,5022,951825,2259921,42.12,38,33,1823,1796,高雄市
2510,2020-06-06 17:54:24,43099,974,38.0,44073,179,44252,109647,40.36,1,0,77,75,鼓山區
2511,2020-06-06 17:54:24,57508,1416,36.37,58924,271,59195,158116,37.44,1,1,103,103,左營區
2512,2020-06-06 17:54:24,17452,443,40.21,17895,96,17991,43397,41.46,1,1,42,42,新興區
2513,2020-06-06 17:54:24,115763,2781,41.16,118544,546,119090,270671,44.0,1,0,189,183,三民區
2514,2020-06-06 17:54:24,60747,1607,40.09,62354,279,62633,149662,41.85,1,0,99,98,楠梓區
2515,2020-06-06 17:54:25,10658,295,44.49,10953,58,11011,23954,45.97,1,1,18,18,旗津區
2516,2020-06-06 17:54:25,55361,1415,42.72,56776,259,57035,129597,44.01,1,1,89,89,小港區
2517,2020-06-06 17:54:25,57069,1421,39.98,58490,295,58785,142733,41.19,1,1,116,116,苓雅區
2518,2020-06-06 17:54:25,66816,1779,42.48,68595,347,68942,157294,43.83,1,1,119,119,前鎮區
2519,2020-06-06 17:54:25,113482,2930,38.59,116412,589,117001,283931,41.21,1,0,228,221,鳳山區
2520,2020-06-06 17:54:25,9437,252,39.81,9689,47,9736,23704,41.07,1,1,22,22,前金區
2521,2020-06-06 17:54:26,33491,880,35.26,34371,190,34561,81326,42.5,1,0,81,70,大寮區
2522,2020-06-06 17:54:26,10559,281,44.29,10840,70,10910,23841,45.76,1,1,21,21,阿蓮區
2523,2020-06-06 17:54:26,10618,306,41.88,10924,91,11015,25354,43.44,1,1,25,25,燕巢區
2524,2020-06-06 17:54:26,32084,895,40.55,32979,190,33169,79113,41.93,1,1,72,72,岡山區
2525,2020-06-06 17:54:26,32787,886,44.32,33673,168,33841,73973,45.75,1,1,47,47,仁武區
2526,2020-06-06 17:54:26,18054,568,42.55,18622,111,18733,42432,44.15,1,1,41,41,路竹區
2527,2020-06-06 17:54:26,2552,92,39.72,2644,21,2665,6425,41.48,1,1,12,12,田寮區
2528,2020-06-06 17:54:26,10929,369,43.55,11298,75,11373,25097,45.32,1,1,24,24,湖內區
2529,2020-06-06 17:54:26,16254,507,49.89,16761,95,16856,32578,51.74,1,1,31,31,橋頭區
2530,2020-06-06 17:54:26,16662,412,42.76,17074,91,17165,38963,44.05,1,1,28,28,鳥松區
2531,2020-06-06 17:54:26,10600,315,41.54,10915,59,10974,25515,43.01,1,1,21,21,茄萣區
2532,2020-06-06 17:54:26,13320,363,45.49,13683,89,13772,29282,47.03,1,1,24,24,大社區
2533,2020-06-06 17:54:26,25028,684,43.44,25712,194,25906,57617,44.96,1,1,51,51,林園區
2534,2020-06-06 17:54:26,15318,389,42.88,15707,89,15796,35719,44.22,1,1,32,32,大樹區
2535,2020-06-06 17:54:27,14032,404,46.35,14436,87,14523,30272,47.98,1,1,28,28,梓官區
2536,2020-06-06 17:54:27,4914,122,42.0,5036,23,5059,11699,43.24,1,1,12,12,永安區
2537,2020-06-06 17:54:27,9749,420,28.58,10169,88,10257,34112,30.07,1,1,32,32,美濃區
2538,2020-06-06 17:54:27,11399,474,37.0,11873,78,11951,30807,38.79,1,1,35,35,旗山區
2539,2020-06-06 17:54:27,6173,193,38.78,6366,48,6414,15918,40.29,1,1,18,18,彌陀區
2540,2020-06-06 17:54:27,2880,164,26.41,3044,40,3084,10903,28.29,1,1,12,12,六龜區
2541,2020-06-06 17:54:28,209,7,8.95,216,0,216,2334,9.25,1,1,4,4,那瑪夏區
2542,2020-06-06 17:54:28,2733,121,26.69,2854,28,2882,10238,28.15,1,1,10,10,杉林區
2543,2020-06-06 17:54:28,60,1,3.95,61,0,61,1520,4.01,1,1,3,3,茂林區
2544,2020-06-06 17:54:28,3863,145,30.86,4008,56,4064,12517,32.47,1,1,18,18,內門區
2545,2020-06-06 17:54:28,201,24,6.01,225,2,227,3342,6.79,1,1,8,8,桃源區
2546,2020-06-06 17:54:28,1223,56,23.41,1279,16,1295,5224,24.79,1,1,7,7,甲仙區
2547,2020-06-06 17:55:18,922191,24612,40.1,946803,5022,951825,2259921,42.12,38,33,1823,1796,高雄市
2548,2020-06-06 17:55:19,9107,221,43.17,9328,57,9385,21094,44.49,1,1,24,24,鹽埕區
2549,2020-06-06 17:55:19,57508,1416,36.37,58924,271,59195,158116,37.44,1,1,103,103,左營區
2550,2020-06-06 17:55:19,17452,443,40.21,17895,96,17991,43397,41.46,1,1,42,42,新興區
2551,2020-06-06 17:55:19,57069,1421,39.98,58490,295,58785,142733,41.19,1,1,116,116,苓雅區
2552,2020-06-06 17:55:19,60747,1607,40.09,62354,279,62633,149662,41.85,1,0,99,98,楠梓區
2553,2020-06-06 17:55:19,115763,2781,41.16,118544,546,119090,270671,44.0,1,0,189,183,三民區
2554,2020-06-06 17:55:19,10658,295,44.49,10953,58,11011,23954,45.97,1,1,18,18,旗津區
2555,2020-06-06 17:55:19,43099,974,38.0,44073,179,44252,109647,40.36,1,0,77,75,鼓山區
2556,2020-06-06 17:55:19,66816,1779,42.48,68595,347,68942,157294,43.83,1,1,119,119,前鎮區
2557,2020-06-06 17:55:19,55361,1415,42.72,56776,259,57035,129597,44.01,1,1,89,89,小港區
2558,2020-06-06 17:55:19,9437,252,39.81,9689,47,9736,23704,41.07,1,1,22,22,前金區
2559,2020-06-06 17:55:20,16254,507,49.89,16761,95,16856,32578,51.74,1,1,31,31,橋頭區
2560,2020-06-06 17:55:20,113482,2930,38.59,116412,589,117001,283931,41.21,1,0,228,221,鳳山區
2561,2020-06-06 17:55:20,32787,886,44.32,33673,168,33841,73973,45.75,1,1,47,47,仁武區
2562,2020-06-06 17:55:20,33491,880,35.26,34371,190,34561,81326,42.5,1,0,81,70,大寮區
2563,2020-06-06 17:55:20,13320,363,45.49,13683,89,13772,29282,47.03,1,1,24,24,大社區
2564,2020-06-06 17:55:20,25028,684,43.44,25712,194,25906,57617,44.96,1,1,51,51,林園區
2565,2020-06-06 17:55:20,32084,895,40.55,32979,190,33169,79113,41.93,1,1,72,72,岡山區
2566,2020-06-06 17:55:20,15318,389,42.88,15707,89,15796,35719,44.22,1,1,32,32,大樹區
2567,2020-06-06 17:55:20,16662,412,42.76,17074,91,17165,38963,44.05,1,1,28,28,鳥松區
2568,2020-06-06 17:55:21,10618,306,41.88,10924,91,11015,25354,43.44,1,1,25,25,燕巢區
2569,2020-06-06 17:55:21,2552,92,39.72,2644,21,2665,6425,41.48,1,1,12,12,田寮區
2570,2020-06-06 17:55:21,18054,568,42.55,18622,111,18733,42432,44.15,1,1,41,41,路竹區
2571,2020-06-06 17:55:21,10559,281,44.29,10840,70,10910,23841,45.76,1,1,21,21,阿蓮區
2572,2020-06-06 17:55:22,2880,164,26.41,3044,40,3084,10903,28.29,1,1,12,12,六龜區
2573,2020-06-06 17:55:22,10600,315,41.54,10915,59,10974,25515,43.01,1,1,21,21,茄萣區
2574,2020-06-06 17:55:22,10929,369,43.55,11298,75,11373,25097,45.32,1,1,24,24,湖內區
2575,2020-06-06 17:55:22,1223,56,23.41,1279,16,1295,5224,24.79,1,1,7,7,甲仙區
2576,2020-06-06 17:55:22,6173,193,38.78,6366,48,6414,15918,40.29,1,1,18,18,彌陀區
2577,2020-06-06 17:55:22,11399,474,37.0,11873,78,11951,30807,38.79,1,1,35,35,旗山區
2578,2020-06-06 17:55:22,14032,404,46.35,14436,87,14523,30272,47.98,1,1,28,28,梓官區
2579,2020-06-06 17:55:22,4914,122,42.0,5036,23,5059,11699,43.24,1,1,12,12,永安區
2580,2020-06-06 17:55:22,9749,420,28.58,10169,88,10257,34112,30.07,1,1,32,32,美濃區
2581,2020-06-06 17:55:23,201,24,6.01,225,2,227,3342,6.79,1,1,8,8,桃源區
2582,2020-06-06 17:55:23,3863,145,30.86,4008,56,4064,12517,32.47,1,1,18,18,內門區
2583,2020-06-06 17:55:23,2733,121,26.69,2854,28,2882,10238,28.15,1,1,10,10,杉林區
2584,2020-06-06 17:55:23,209,7,8.95,216,0,216,2334,9.25,1,1,4,4,那瑪夏區
2585,2020-06-06 17:55:23,60,1,3.95,61,0,61,1520,4.01,1,1,3,3,茂林區
2586,2020-06-06 17:56:13,60747,1607,40.09,62354,279,62633,149662,41.85,1,0,99,98,楠梓區
2587,2020-06-06 17:56:13,922191,24612,40.1,946803,5022,951825,2259921,42.12,38,33,1823,1796,高雄市
2588,2020-06-06 17:56:13,57508,1416,36.37,58924,271,59195,158116,37.44,1,1,103,103,左營區
2589,2020-06-06 17:56:13,43099,974,38.0,44073,179,44252,109647,40.36,1,0,77,75,鼓山區
2590,2020-06-06 17:56:13,9107,221,43.17,9328,57,9385,21094,44.49,1,1,24,24,鹽埕區
2591,2020-06-06 17:56:14,17452,443,40.21,17895,96,17991,43397,41.46,1,1,42,42,新興區
2592,2020-06-06 17:56:14,16662,412,42.76,17074,91,17165,38963,44.05,1,1,28,28,鳥松區
2593,2020-06-06 17:56:14,13320,363,45.49,13683,89,13772,29282,47.03,1,1,24,24,大社區
2594,2020-06-06 17:56:14,25028,684,43.44,25712,194,25906,57617,44.96,1,1,51,51,林園區
2595,2020-06-06 17:56:14,9437,252,39.81,9689,47,9736,23704,41.07,1,1,22,22,前金區
2596,2020-06-06 17:56:14,66816,1779,42.48,68595,347,68942,157294,43.83,1,1,119,119,前鎮區
2597,2020-06-06 17:56:14,32787,886,44.32,33673,168,33841,73973,45.75,1,1,47,47,仁武區
2598,2020-06-06 17:56:14,33491,880,35.26,34371,190,34561,81326,42.5,1,0,81,70,大寮區
2599,2020-06-06 17:56:14,16254,507,49.89,16761,95,16856,32578,51.74,1,1,31,31,橋頭區
2600,2020-06-06 17:56:14,10658,295,44.49,10953,58,11011,23954,45.97,1,1,18,18,旗津區
2601,2020-06-06 17:56:14,57069,1421,39.98,58490,295,58785,142733,41.19,1,1,116,116,苓雅區
2602,2020-06-06 17:56:14,15318,389,42.88,15707,89,15796,35719,44.22,1,1,32,32,大樹區
2603,2020-06-06 17:56:14,115763,2781,41.16,118544,546,119090,270671,44.0,1,0,189,183,三民區
2604,2020-06-06 17:56:14,113482,2930,38.59,116412,589,117001,283931,41.21,1,0,228,221,鳳山區
2605,2020-06-06 17:56:14,55361,1415,42.72,56776,259,57035,129597,44.01,1,1,89,89,小港區
2606,2020-06-06 17:56:14,32084,895,40.55,32979,190,33169,79113,41.93,1,1,72,72,岡山區
2607,2020-06-06 17:56:15,10600,315,41.54,10915,59,10974,25515,43.01,1,1,21,21,茄萣區
2608,2020-06-06 17:56:15,18054,568,42.55,18622,111,18733,42432,44.15,1,1,41,41,路竹區
2609,2020-06-06 17:56:15,14032,404,46.35,14436,87,14523,30272,47.98,1,1,28,28,梓官區
2610,2020-06-06 17:56:15,10559,281,44.29,10840,70,10910,23841,45.76,1,1,21,21,阿蓮區
2611,2020-06-06 17:56:15,2733,121,26.69,2854,28,2882,10238,28.15,1,1,10,10,杉林區
2612,2020-06-06 17:56:15,2880,164,26.41,3044,40,3084,10903,28.29,1,1,12,12,六龜區
2613,2020-06-06 17:56:15,6173,193,38.78,6366,48,6414,15918,40.29,1,1,18,18,彌陀區
2614,2020-06-06 17:56:15,10618,306,41.88,10924,91,11015,25354,43.44,1,1,25,25,燕巢區
2615,2020-06-06 17:56:15,10929,369,43.55,11298,75,11373,25097,45.32,1,1,24,24,湖內區
2616,2020-06-06 17:56:15,1223,56,23.41,1279,16,1295,5224,24.79,1,1,7,7,甲仙區
2617,2020-06-06 17:56:15,4914,122,42.0,5036,23,5059,11699,43.24,1,1,12,12,永安區
2618,2020-06-06 17:56:15,9749,420,28.58,10169,88,10257,34112,30.07,1,1,32,32,美濃區
2619,2020-06-06 17:56:15,2552,92,39.72,2644,21,2665,6425,41.48,1,1,12,12,田寮區
2620,2020-06-06 17:56:15,11399,474,37.0,11873,78,11951,30807,38.79,1,1,35,35,旗山區
2621,2020-06-06 17:56:16,209,7,8.95,216,0,216,2334,9.25,1,1,4,4,那瑪夏區
2622,2020-06-06 17:56:16,201,24,6.01,225,2,227,3342,6.79,1,1,8,8,桃源區
2623,2020-06-06 17:56:16,3863,145,30.86,4008,56,4064,12517,32.47,1,1,18,18,內門區
2624,2020-06-06 17:56:16,60,1,3.95,61,0,61,1520,4.01,1,1,3,3,茂林區
2625,2020-06-06 17:57:06,43099,974,38.0,44073,179,44252,109647,40.36,1,0,77,75,鼓山區
2626,2020-06-06 17:57:06,922191,24612,40.1,946803,5022,951825,2259921,42.12,38,33,1823,1796,高雄市
2627,2020-06-06 17:57:06,57508,1416,36.37,58924,271,59195,158116,37.44,1,1,103,103,左營區
2628,2020-06-06 17:57:06,115763,2781,41.16,118544,546,119090,270671,44.0,1,0,189,183,三民區
2629,2020-06-06 17:57:06,17452,443,40.21,17895,96,17991,43397,41.46,1,1,42,42,新興區
2630,2020-06-06 17:57:06,60747,1607,40.09,62354,279,62633,149662,41.85,1,0,99,98,楠梓區
2631,2020-06-06 17:57:06,9107,221,43.17,9328,57,9385,21094,44.49,1,1,24,24,鹽埕區
2632,2020-06-06 17:57:07,16254,507,49.89,16761,95,16856,32578,51.74,1,1,31,31,橋頭區
2633,2020-06-06 17:57:07,15318,389,42.88,15707,89,15796,35719,44.22,1,1,32,32,大樹區
2634,2020-06-06 17:57:07,9437,252,39.81,9689,47,9736,23704,41.07,1,1,22,22,前金區
2635,2020-06-06 17:57:07,57069,1421,39.98,58490,295,58785,142733,41.19,1,1,116,116,苓雅區
2636,2020-06-06 17:57:07,32787,886,44.32,33673,168,33841,73973,45.75,1,1,47,47,仁武區
2637,2020-06-06 17:57:07,33491,880,35.26,34371,190,34561,81326,42.5,1,0,81,70,大寮區
2638,2020-06-06 17:57:07,32084,895,40.55,32979,190,33169,79113,41.93,1,1,72,72,岡山區
2639,2020-06-06 17:57:07,66816,1779,42.48,68595,347,68942,157294,43.83,1,1,119,119,前鎮區
2640,2020-06-06 17:57:07,55361,1415,42.72,56776,259,57035,129597,44.01,1,1,89,89,小港區
2641,2020-06-06 17:57:07,113482,2930,38.59,116412,589,117001,283931,41.21,1,0,228,221,鳳山區
2642,2020-06-06 17:57:07,13320,363,45.49,13683,89,13772,29282,47.03,1,1,24,24,大社區
2643,2020-06-06 17:57:07,16662,412,42.76,17074,91,17165,38963,44.05,1,1,28,28,鳥松區
2644,2020-06-06 17:57:07,10618,306,41.88,10924,91,11015,25354,43.44,1,1,25,25,燕巢區
2645,2020-06-06 17:57:07,25028,684,43.44,25712,194,25906,57617,44.96,1,1,51,51,林園區
2646,2020-06-06 17:57:07,10658,295,44.49,10953,58,11011,23954,45.97,1,1,18,18,旗津區
2647,2020-06-06 17:57:08,3863,145,30.86,4008,56,4064,12517,32.47,1,1,18,18,內門區
2648,2020-06-06 17:57:08,14032,404,46.35,14436,87,14523,30272,47.98,1,1,28,28,梓官區
2649,2020-06-06 17:57:08,2880,164,26.41,3044,40,3084,10903,28.29,1,1,12,12,六龜區
2650,2020-06-06 17:57:08,4914,122,42.0,5036,23,5059,11699,43.24,1,1,12,12,永安區
2651,2020-06-06 17:57:08,1223,56,23.41,1279,16,1295,5224,24.79,1,1,7,7,甲仙區
2652,2020-06-06 17:57:08,10600,315,41.54,10915,59,10974,25515,43.01,1,1,21,21,茄萣區
2653,2020-06-06 17:57:08,18054,568,42.55,18622,111,18733,42432,44.15,1,1,41,41,路竹區
2654,2020-06-06 17:57:08,2552,92,39.72,2644,21,2665,6425,41.48,1,1,12,12,田寮區
2655,2020-06-06 17:57:08,10929,369,43.55,11298,75,11373,25097,45.32,1,1,24,24,湖內區
2656,2020-06-06 17:57:08,201,24,6.01,225,2,227,3342,6.79,1,1,8,8,桃源區
2657,2020-06-06 17:57:08,11399,474,37.0,11873,78,11951,30807,38.79,1,1,35,35,旗山區
2658,2020-06-06 17:57:08,2733,121,26.69,2854,28,2882,10238,28.15,1,1,10,10,杉林區
2659,2020-06-06 17:57:08,6173,193,38.78,6366,48,6414,15918,40.29,1,1,18,18,彌陀區
2660,2020-06-06 17:57:08,10559,281,44.29,10840,70,10910,23841,45.76,1,1,21,21,阿蓮區
2661,2020-06-06 17:57:08,60,1,3.95,61,0,61,1520,4.01,1,1,3,3,茂林區
2662,2020-06-06 17:57:08,9749,420,28.58,10169,88,10257,34112,30.07,1,1,32,32,美濃區
2663,2020-06-06 17:57:09,209,7,8.95,216,0,216,2334,9.25,1,1,4,4,那瑪夏區
2664,2020-06-06 17:57:59,66816,1779,42.48,68595,347,68942,157294,43.83,1,1,119,119,前鎮區
2665,2020-06-06 17:57:59,25028,684,43.44,25712,194,25906,57617,44.96,1,1,51,51,林園區
2666,2020-06-06 17:57:59,116582,2807,41.45,119389,555,119944,272596,44.0,1,0,189,184,三民區
2667,2020-06-06 17:57:59,114770,2962,39.03,117732,597,118329,286771,41.26,1,0,228,223,鳳山區
2668,2020-06-06 17:57:59,924940,24686,40.22,949626,5043,954669,2266548,42.12,38,34,1823,1800,高雄市
2669,2020-06-06 17:57:59,55361,1415,42.72,56776,259,57035,129597,44.01,1,1,89,89,小港區
2670,2020-06-06 17:57:59,10658,295,44.49,10953,58,11011,23954,45.97,1,1,18,18,旗津區
2671,2020-06-06 17:57:59,17452,443,40.21,17895,96,17991,43397,41.46,1,1,42,42,新興區
2672,2020-06-06 17:57:59,57508,1416,36.37,58924,271,59195,158116,37.44,1,1,103,103,左營區
2673,2020-06-06 17:57:59,61389,1623,40.51,63012,283,63295,151524,41.77,1,1,99,99,楠梓區
2674,2020-06-06 17:57:59,43099,974,38.0,44073,179,44252,109647,40.36,1,0,77,75,鼓山區
2675,2020-06-06 17:57:59,9107,221,43.17,9328,57,9385,21094,44.49,1,1,24,24,鹽埕區
2676,2020-06-06 17:57:59,57069,1421,39.98,58490,295,58785,142733,41.19,1,1,116,116,苓雅區
2677,2020-06-06 17:57:59,9437,252,39.81,9689,47,9736,23704,41.07,1,1,22,22,前金區
2678,2020-06-06 17:58:00,10618,306,41.88,10924,91,11015,25354,43.44,1,1,25,25,燕巢區
2679,2020-06-06 17:58:00,10600,315,41.54,10915,59,10974,25515,43.01,1,1,21,21,茄萣區
2680,2020-06-06 17:58:00,16254,507,49.89,16761,95,16856,32578,51.74,1,1,31,31,橋頭區
2681,2020-06-06 17:58:00,10929,369,43.55,11298,75,11373,25097,45.32,1,1,24,24,湖內區
2682,2020-06-06 17:58:00,13320,363,45.49,13683,89,13772,29282,47.03,1,1,24,24,大社區
2683,2020-06-06 17:58:00,4914,122,42.0,5036,23,5059,11699,43.24,1,1,12,12,永安區
2684,2020-06-06 17:58:00,18054,568,42.55,18622,111,18733,42432,44.15,1,1,41,41,路竹區
2685,2020-06-06 17:58:00,2552,92,39.72,2644,21,2665,6425,41.48,1,1,12,12,田寮區
2686,2020-06-06 17:58:00,32084,895,40.55,32979,190,33169,79113,41.93,1,1,72,72,岡山區
2687,2020-06-06 17:58:00,33491,880,35.26,34371,190,34561,81326,42.5,1,0,81,70,大寮區
2688,2020-06-06 17:58:00,16662,412,42.76,17074,91,17165,38963,44.05,1,1,28,28,鳥松區
2689,2020-06-06 17:58:00,10559,281,44.29,10840,70,10910,23841,45.76,1,1,21,21,阿蓮區
2690,2020-06-06 17:58:00,15318,389,42.88,15707,89,15796,35719,44.22,1,1,32,32,大樹區
2691,2020-06-06 17:58:00,32787,886,44.32,33673,168,33841,73973,45.75,1,1,47,47,仁武區
2692,2020-06-06 17:58:01,14032,404,46.35,14436,87,14523,30272,47.98,1,1,28,28,梓官區
2693,2020-06-06 17:58:01,2880,164,26.41,3044,40,3084,10903,28.29,1,1,12,12,六龜區
2694,2020-06-06 17:58:01,11399,474,37.0,11873,78,11951,30807,38.79,1,1,35,35,旗山區
2695,2020-06-06 17:58:01,2733,121,26.69,2854,28,2882,10238,28.15,1,1,10,10,杉林區
2696,2020-06-06 17:58:01,9749,420,28.58,10169,88,10257,34112,30.07,1,1,32,32,美濃區
2697,2020-06-06 17:58:01,60,1,3.95,61,0,61,1520,4.01,1,1,3,3,茂林區
2698,2020-06-06 17:58:01,6173,193,38.78,6366,48,6414,15918,40.29,1,1,18,18,彌陀區
2699,2020-06-06 17:58:01,1223,56,23.41,1279,16,1295,5224,24.79,1,1,7,7,甲仙區
2700,2020-06-06 17:58:01,209,7,8.95,216,0,216,2334,9.25,1,1,4,4,那瑪夏區
2701,2020-06-06 17:58:01,3863,145,30.86,4008,56,4064,12517,32.47,1,1,18,18,內門區
2702,2020-06-06 17:58:01,201,24,6.01,225,2,227,3342,6.79,1,1,8,8,桃源區
2703,2020-06-06 17:58:51,9107,221,43.17,9328,57,9385,21094,44.49,1,1,24,24,鹽埕區
2704,2020-06-06 17:58:51,924940,24686,40.22,949626,5043,954669,2266548,42.12,38,34,1823,1800,高雄市
2705,2020-06-06 17:58:52,55361,1415,42.72,56776,259,57035,129597,44.01,1,1,89,89,小港區
2706,2020-06-06 17:58:52,33491,880,35.26,34371,190,34561,81326,42.5,1,0,81,70,大寮區
2707,2020-06-06 17:58:52,9437,252,39.81,9689,47,9736,23704,41.07,1,1,22,22,前金區
2708,2020-06-06 17:58:52,61389,1623,40.51,63012,283,63295,151524,41.77,1,1,99,99,楠梓區
2709,2020-06-06 17:58:52,57508,1416,36.37,58924,271,59195,158116,37.44,1,1,103,103,左營區
2710,2020-06-06 17:58:52,10658,295,44.49,10953,58,11011,23954,45.97,1,1,18,18,旗津區
2711,2020-06-06 17:58:52,116582,2807,41.45,119389,555,119944,272596,44.0,1,0,189,184,三民區
2712,2020-06-06 17:58:52,17452,443,40.21,17895,96,17991,43397,41.46,1,1,42,42,新興區
2713,2020-06-06 17:58:52,114770,2962,39.03,117732,597,118329,286771,41.26,1,0,228,223,鳳山區
2714,2020-06-06 17:58:52,25028,684,43.44,25712,194,25906,57617,44.96,1,1,51,51,林園區
2715,2020-06-06 17:58:52,66816,1779,42.48,68595,347,68942,157294,43.83,1,1,119,119,前鎮區
2716,2020-06-06 17:58:52,43099,974,38.0,44073,179,44252,109647,40.36,1,0,77,75,鼓山區
2717,2020-06-06 17:58:52,57069,1421,39.98,58490,295,58785,142733,41.19,1,1,116,116,苓雅區
2718,2020-06-06 17:58:53,13320,363,45.49,13683,89,13772,29282,47.03,1,1,24,24,大社區
2719,2020-06-06 17:58:53,32084,895,40.55,32979,190,33169,79113,41.93,1,1,72,72,岡山區
2720,2020-06-06 17:58:53,16254,507,49.89,16761,95,16856,32578,51.74,1,1,31,31,橋頭區
2721,2020-06-06 17:58:53,10618,306,41.88,10924,91,11015,25354,43.44,1,1,25,25,燕巢區
2722,2020-06-06 17:58:53,10929,369,43.55,11298,75,11373,25097,45.32,1,1,24,24,湖內區
2723,2020-06-06 17:58:53,2552,92,39.72,2644,21,2665,6425,41.48,1,1,12,12,田寮區
2724,2020-06-06 17:58:53,15318,389,42.88,15707,89,15796,35719,44.22,1,1,32,32,大樹區
2725,2020-06-06 17:58:53,18054,568,42.55,18622,111,18733,42432,44.15,1,1,41,41,路竹區
2726,2020-06-06 17:58:53,32787,886,44.32,33673,168,33841,73973,45.75,1,1,47,47,仁武區
2727,2020-06-06 17:58:53,10600,315,41.54,10915,59,10974,25515,43.01,1,1,21,21,茄萣區
2728,2020-06-06 17:58:53,16662,412,42.76,17074,91,17165,38963,44.05,1,1,28,28,鳥松區
2729,2020-06-06 17:58:53,10559,281,44.29,10840,70,10910,23841,45.76,1,1,21,21,阿蓮區
2730,2020-06-06 17:58:54,9749,420,28.58,10169,88,10257,34112,30.07,1,1,32,32,美濃區
2731,2020-06-06 17:58:54,2733,121,26.69,2854,28,2882,10238,28.15,1,1,10,10,杉林區
2732,2020-06-06 17:58:54,3863,145,30.86,4008,56,4064,12517,32.47,1,1,18,18,內門區
2733,2020-06-06 17:58:54,4914,122,42.0,5036,23,5059,11699,43.24,1,1,12,12,永安區
2734,2020-06-06 17:58:54,14032,404,46.35,14436,87,14523,30272,47.98,1,1,28,28,梓官區
2735,2020-06-06 17:58:54,201,24,6.01,225,2,227,3342,6.79,1,1,8,8,桃源區
2736,2020-06-06 17:58:54,11399,474,37.0,11873,78,11951,30807,38.79,1,1,35,35,旗山區
2737,2020-06-06 17:58:54,1223,56,23.41,1279,16,1295,5224,24.79,1,1,7,7,甲仙區
2738,2020-06-06 17:58:54,209,7,8.95,216,0,216,2334,9.25,1,1,4,4,那瑪夏區
2739,2020-06-06 17:58:54,6173,193,38.78,6366,48,6414,15918,40.29,1,1,18,18,彌陀區
2740,2020-06-06 17:58:54,60,1,3.95,61,0,61,1520,4.01,1,1,3,3,茂林區
2741,2020-06-06 17:58:54,2880,164,26.41,3044,40,3084,10903,28.29,1,1,12,12,六龜區
2742,2020-06-06 17:59:44,924940,24686,40.22,949626,5043,954669,2266548,42.12,38,34,1823,1800,高雄市
2743,2020-06-06 17:59:45,10658,295,44.49,10953,58,11011,23954,45.97,1,1,18,18,旗津區
2744,2020-06-06 17:59:45,61389,1623,40.51,63012,283,63295,151524,41.77,1,1,99,99,楠梓區
2745,2020-06-06 17:59:45,9107,221,43.17,9328,57,9385,21094,44.49,1,1,24,24,鹽埕區
2746,2020-06-06 17:59:45,9437,252,39.81,9689,47,9736,23704,41.07,1,1,22,22,前金區
2747,2020-06-06 17:59:45,66816,1779,42.48,68595,347,68942,157294,43.83,1,1,119,119,前鎮區
2748,2020-06-06 17:59:45,57069,1421,39.98,58490,295,58785,142733,41.19,1,1,116,116,苓雅區
2749,2020-06-06 17:59:45,55361,1415,42.72,56776,259,57035,129597,44.01,1,1,89,89,小港區
2750,2020-06-06 17:59:45,17452,443,40.21,17895,96,17991,43397,41.46,1,1,42,42,新興區
2751,2020-06-06 17:59:45,57508,1416,36.37,58924,271,59195,158116,37.44,1,1,103,103,左營區
2752,2020-06-06 17:59:45,116582,2807,41.45,119389,555,119944,272596,44.0,1,0,189,184,三民區
2753,2020-06-06 17:59:45,43099,974,38.0,44073,179,44252,109647,40.36,1,0,77,75,鼓山區
2754,2020-06-06 17:59:46,16662,412,42.76,17074,91,17165,38963,44.05,1,1,28,28,鳥松區
2755,2020-06-06 17:59:46,15318,389,42.88,15707,89,15796,35719,44.22,1,1,32,32,大樹區
2756,2020-06-06 17:59:46,13320,363,45.49,13683,89,13772,29282,47.03,1,1,24,24,大社區
2757,2020-06-06 17:59:46,33491,880,35.26,34371,190,34561,81326,42.5,1,0,81,70,大寮區
2758,2020-06-06 17:59:46,25028,684,43.44,25712,194,25906,57617,44.96,1,1,51,51,林園區
2759,2020-06-06 17:59:46,10618,306,41.88,10924,91,11015,25354,43.44,1,1,25,25,燕巢區
2760,2020-06-06 17:59:46,10559,281,44.29,10840,70,10910,23841,45.76,1,1,21,21,阿蓮區
2761,2020-06-06 17:59:46,32787,886,44.32,33673,168,33841,73973,45.75,1,1,47,47,仁武區
2762,2020-06-06 17:59:46,2552,92,39.72,2644,21,2665,6425,41.48,1,1,12,12,田寮區
2763,2020-06-06 17:59:46,32084,895,40.55,32979,190,33169,79113,41.93,1,1,72,72,岡山區
2764,2020-06-06 17:59:46,114770,2962,39.03,117732,597,118329,286771,41.26,1,0,228,223,鳳山區
2765,2020-06-06 17:59:46,16254,507,49.89,16761,95,16856,32578,51.74,1,1,31,31,橋頭區
2766,2020-06-06 17:59:47,11399,474,37.0,11873,78,11951,30807,38.79,1,1,35,35,旗山區
2767,2020-06-06 17:59:47,10600,315,41.54,10915,59,10974,25515,43.01,1,1,21,21,茄萣區
2768,2020-06-06 17:59:47,4914,122,42.0,5036,23,5059,11699,43.24,1,1,12,12,永安區
2769,2020-06-06 17:59:47,14032,404,46.35,14436,87,14523,30272,47.98,1,1,28,28,梓官區
2770,2020-06-06 17:59:47,9749,420,28.58,10169,88,10257,34112,30.07,1,1,32,32,美濃區
2771,2020-06-06 17:59:47,2880,164,26.41,3044,40,3084,10903,28.29,1,1,12,12,六龜區
2772,2020-06-06 17:59:47,18054,568,42.55,18622,111,18733,42432,44.15,1,1,41,41,路竹區
2773,2020-06-06 17:59:47,10929,369,43.55,11298,75,11373,25097,45.32,1,1,24,24,湖內區
2774,2020-06-06 17:59:47,6173,193,38.78,6366,48,6414,15918,40.29,1,1,18,18,彌陀區
2775,2020-06-06 17:59:48,209,7,8.95,216,0,216,2334,9.25,1,1,4,4,那瑪夏區
2776,2020-06-06 17:59:48,2733,121,26.69,2854,28,2882,10238,28.15,1,1,10,10,杉林區
2777,2020-06-06 17:59:48,60,1,3.95,61,0,61,1520,4.01,1,1,3,3,茂林區
2778,2020-06-06 17:59:48,1223,56,23.41,1279,16,1295,5224,24.79,1,1,7,7,甲仙區
2779,2020-06-06 17:59:48,201,24,6.01,225,2,227,3342,6.79,1,1,8,8,桃源區
2780,2020-06-06 17:59:48,3863,145,30.86,4008,56,4064,12517,32.47,1,1,18,18,內門區
2781,2020-06-06 18:00:39,57069,1421,39.98,58490,295,58785,142733,41.19,1,1,116,116,苓雅區
2782,2020-06-06 18:00:39,55361,1415,42.72,56776,259,57035,129597,44.01,1,1,89,89,小港區
2783,2020-06-06 18:00:39,57508,1416,36.37,58924,271,59195,158116,37.44,1,1,103,103,左營區
2784,2020-06-06 18:00:39,61389,1623,40.51,63012,283,63295,151524,41.77,1,1,99,99,楠梓區
2785,2020-06-06 18:00:39,43805,995,38.62,44800,186,44986,111615,40.3,1,0,77,76,鼓山區
2786,2020-06-06 18:00:39,9437,252,39.81,9689,47,9736,23704,41.07,1,1,22,22,前金區
2787,2020-06-06 18:00:39,117196,2828,41.67,120024,556,120580,274062,44.0,1,0,189,185,三民區
2788,2020-06-06 18:00:39,928481,24793,40.37,953274,5066,958340,2274796,42.13,38,34,1823,1806,高雄市
2789,2020-06-06 18:00:39,9107,221,43.17,9328,57,9385,21094,44.49,1,1,24,24,鹽埕區
2790,2020-06-06 18:00:39,10658,295,44.49,10953,58,11011,23954,45.97,1,1,18,18,旗津區
2791,2020-06-06 18:00:39,66816,1779,42.48,68595,347,68942,157294,43.83,1,1,119,119,前鎮區
2792,2020-06-06 18:00:39,17452,443,40.21,17895,96,17991,43397,41.46,1,1,42,42,新興區
2793,2020-06-06 18:00:40,25028,684,43.44,25712,194,25906,57617,44.96,1,1,51,51,林園區
2794,2020-06-06 18:00:40,13320,363,45.49,13683,89,13772,29282,47.03,1,1,24,24,大社區
2795,2020-06-06 18:00:40,32787,886,44.32,33673,168,33841,73973,45.75,1,1,47,47,仁武區
2796,2020-06-06 18:00:40,10618,306,41.88,10924,91,11015,25354,43.44,1,1,25,25,燕巢區
2797,2020-06-06 18:00:40,16254,507,49.89,16761,95,16856,32578,51.74,1,1,31,31,橋頭區
2798,2020-06-06 18:00:40,115466,2984,39.26,118450,602,119052,288251,41.3,1,0,228,224,鳳山區
2799,2020-06-06 18:00:40,15318,389,42.88,15707,89,15796,35719,44.22,1,1,32,32,大樹區
2800,2020-06-06 18:00:40,35016,923,36.86,35939,200,36139,84660,42.69,1,0,81,73,大寮區
2801,2020-06-06 18:00:40,32084,895,40.55,32979,190,33169,79113,41.93,1,1,72,72,岡山區
2802,2020-06-06 18:00:40,16662,412,42.76,17074,91,17165,38963,44.05,1,1,28,28,鳥松區
2803,2020-06-06 18:00:41,6173,193,38.78,6366,48,6414,15918,40.29,1,1,18,18,彌陀區
2804,2020-06-06 18:00:41,10929,369,43.55,11298,75,11373,25097,45.32,1,1,24,24,湖內區
2805,2020-06-06 18:00:41,14032,404,46.35,14436,87,14523,30272,47.98,1,1,28,28,梓官區
2806,2020-06-06 18:00:41,4914,122,42.0,5036,23,5059,11699,43.24,1,1,12,12,永安區
2807,2020-06-06 18:00:41,18054,568,42.55,18622,111,18733,42432,44.15,1,1,41,41,路竹區
2808,2020-06-06 18:00:41,10559,281,44.29,10840,70,10910,23841,45.76,1,1,21,21,阿蓮區
2809,2020-06-06 18:00:41,10600,315,41.54,10915,59,10974,25515,43.01,1,1,21,21,茄萣區
2810,2020-06-06 18:00:41,2552,92,39.72,2644,21,2665,6425,41.48,1,1,12,12,田寮區
2811,2020-06-06 18:00:42,1223,56,23.41,1279,16,1295,5224,24.79,1,1,7,7,甲仙區
2812,2020-06-06 18:00:42,11399,474,37.0,11873,78,11951,30807,38.79,1,1,35,35,旗山區
2813,2020-06-06 18:00:42,2880,164,26.41,3044,40,3084,10903,28.29,1,1,12,12,六龜區
2814,2020-06-06 18:00:42,3863,145,30.86,4008,56,4064,12517,32.47,1,1,18,18,內門區
2815,2020-06-06 18:00:42,9749,420,28.58,10169,88,10257,34112,30.07,1,1,32,32,美濃區
2816,2020-06-06 18:00:42,2733,121,26.69,2854,28,2882,10238,28.15,1,1,10,10,杉林區
2817,2020-06-06 18:00:43,60,1,3.95,61,0,61,1520,4.01,1,1,3,3,茂林區
2818,2020-06-06 18:00:43,201,24,6.01,225,2,227,3342,6.79,1,1,8,8,桃源區
2819,2020-06-06 18:00:43,209,7,8.95,216,0,216,2334,9.25,1,1,4,4,那瑪夏區
2820,2020-06-06 18:01:33,928481,24793,40.37,953274,5066,958340,2274796,42.13,38,34,1823,1806,高雄市
2821,2020-06-06 18:01:33,9107,221,43.17,9328,57,9385,21094,44.49,1,1,24,24,鹽埕區
2822,2020-06-06 18:01:34,43805,995,38.62,44800,186,44986,111615,40.3,1,0,77,76,鼓山區
2823,2020-06-06 18:01:34,61389,1623,40.51,63012,283,63295,151524,41.77,1,1,99,99,楠梓區
2824,2020-06-06 18:01:34,57508,1416,36.37,58924,271,59195,158116,37.44,1,1,103,103,左營區
2825,2020-06-06 18:01:34,17452,443,40.21,17895,96,17991,43397,41.46,1,1,42,42,新興區
2826,2020-06-06 18:01:34,117196,2828,41.67,120024,556,120580,274062,44.0,1,0,189,185,三民區
2827,2020-06-06 18:01:35,10658,295,44.49,10953,58,11011,23954,45.97,1,1,18,18,旗津區
2828,2020-06-06 18:01:35,57069,1421,39.98,58490,295,58785,142733,41.19,1,1,116,116,苓雅區
2829,2020-06-06 18:01:35,9437,252,39.81,9689,47,9736,23704,41.07,1,1,22,22,前金區
2830,2020-06-06 18:01:35,66816,1779,42.48,68595,347,68942,157294,43.83,1,1,119,119,前鎮區
2831,2020-06-06 18:01:36,115466,2984,39.26,118450,602,119052,288251,41.3,1,0,228,224,鳳山區
2832,2020-06-06 18:01:36,55361,1415,42.72,56776,259,57035,129597,44.01,1,1,89,89,小港區
2833,2020-06-06 18:01:37,13320,363,45.49,13683,89,13772,29282,47.03,1,1,24,24,大社區
2834,2020-06-06 18:01:37,35016,923,36.86,35939,200,36139,84660,42.69,1,0,81,73,大寮區
2835,2020-06-06 18:01:37,25028,684,43.44,25712,194,25906,57617,44.96,1,1,51,51,林園區
2836,2020-06-06 18:01:37,15318,389,42.88,15707,89,15796,35719,44.22,1,1,32,32,大樹區
2837,2020-06-06 18:01:38,32787,886,44.32,33673,168,33841,73973,45.75,1,1,47,47,仁武區
2838,2020-06-06 18:01:38,16254,507,49.89,16761,95,16856,32578,51.74,1,1,31,31,橋頭區
2839,2020-06-06 18:01:38,10618,306,41.88,10924,91,11015,25354,43.44,1,1,25,25,燕巢區
2840,2020-06-06 18:01:38,32084,895,40.55,32979,190,33169,79113,41.93,1,1,72,72,岡山區
2841,2020-06-06 18:01:38,2552,92,39.72,2644,21,2665,6425,41.48,1,1,12,12,田寮區
2842,2020-06-06 18:01:38,16662,412,42.76,17074,91,17165,38963,44.05,1,1,28,28,鳥松區
2843,2020-06-06 18:01:39,10600,315,41.54,10915,59,10974,25515,43.01,1,1,21,21,茄萣區
2844,2020-06-06 18:01:39,6173,193,38.78,6366,48,6414,15918,40.29,1,1,18,18,彌陀區
2845,2020-06-06 18:01:39,10929,369,43.55,11298,75,11373,25097,45.32,1,1,24,24,湖內區
2846,2020-06-06 18:01:39,10559,281,44.29,10840,70,10910,23841,45.76,1,1,21,21,阿蓮區
2847,2020-06-06 18:01:39,4914,122,42.0,5036,23,5059,11699,43.24,1,1,12,12,永安區
2848,2020-06-06 18:01:39,18054,568,42.55,18622,111,18733,42432,44.15,1,1,41,41,路竹區
2849,2020-06-06 18:01:40,2733,121,26.69,2854,28,2882,10238,28.15,1,1,10,10,杉林區
2850,2020-06-06 18:01:40,9749,420,28.58,10169,88,10257,34112,30.07,1,1,32,32,美濃區
2851,2020-06-06 18:01:40,11399,474,37.0,11873,78,11951,30807,38.79,1,1,35,35,旗山區
2852,2020-06-06 18:01:40,2880,164,26.41,3044,40,3084,10903,28.29,1,1,12,12,六龜區
2853,2020-06-06 18:01:40,3863,145,30.86,4008,56,4064,12517,32.47,1,1,18,18,內門區
2854,2020-06-06 18:01:40,60,1,3.95,61,0,61,1520,4.01,1,1,3,3,茂林區
2855,2020-06-06 18:01:40,201,24,6.01,225,2,227,3342,6.79,1,1,8,8,桃源區
2856,2020-06-06 18:01:40,14032,404,46.35,14436,87,14523,30272,47.98,1,1,28,28,梓官區
2857,2020-06-06 18:01:40,1223,56,23.41,1279,16,1295,5224,24.79,1,1,7,7,甲仙區
2858,2020-06-06 18:01:41,209,7,8.95,216,0,216,2334,9.25,1,1,4,4,那瑪夏區
2859,2020-06-06 18:02:31,117196,2828,41.67,120024,556,120580,274062,44.0,1,0,189,185,三民區
2860,2020-06-06 18:02:31,43805,995,38.62,44800,186,44986,111615,40.3,1,0,77,76,鼓山區
2861,2020-06-06 18:02:31,17452,443,40.21,17895,96,17991,43397,41.46,1,1,42,42,新興區
2862,2020-06-06 18:02:31,61389,1623,40.51,63012,283,63295,151524,41.77,1,1,99,99,楠梓區
2863,2020-06-06 18:02:31,928481,24793,40.37,953274,5066,958340,2274796,42.13,38,34,1823,1806,高雄市
2864,2020-06-06 18:02:31,57508,1416,36.37,58924,271,59195,158116,37.44,1,1,103,103,左營區
2865,2020-06-06 18:02:31,9107,221,43.17,9328,57,9385,21094,44.49,1,1,24,24,鹽埕區
2866,2020-06-06 18:02:32,10658,295,44.49,10953,58,11011,23954,45.97,1,1,18,18,旗津區
2867,2020-06-06 18:02:32,9437,252,39.81,9689,47,9736,23704,41.07,1,1,22,22,前金區
2868,2020-06-06 18:02:32,57069,1421,39.98,58490,295,58785,142733,41.19,1,1,116,116,苓雅區
2869,2020-06-06 18:02:32,66816,1779,42.48,68595,347,68942,157294,43.83,1,1,119,119,前鎮區
2870,2020-06-06 18:02:33,32084,895,40.55,32979,190,33169,79113,41.93,1,1,72,72,岡山區
2871,2020-06-06 18:02:33,16662,412,42.76,17074,91,17165,38963,44.05,1,1,28,28,鳥松區
2872,2020-06-06 18:02:33,13320,363,45.49,13683,89,13772,29282,47.03,1,1,24,24,大社區
2873,2020-06-06 18:02:33,35016,923,36.86,35939,200,36139,84660,42.69,1,0,81,73,大寮區
2874,2020-06-06 18:02:33,15318,389,42.88,15707,89,15796,35719,44.22,1,1,32,32,大樹區
2875,2020-06-06 18:02:33,55361,1415,42.72,56776,259,57035,129597,44.01,1,1,89,89,小港區
2876,2020-06-06 18:02:33,25028,684,43.44,25712,194,25906,57617,44.96,1,1,51,51,林園區
2877,2020-06-06 18:02:33,32787,886,44.32,33673,168,33841,73973,45.75,1,1,47,47,仁武區
2878,2020-06-06 18:02:33,115466,2984,39.26,118450,602,119052,288251,41.3,1,0,228,224,鳳山區
2879,2020-06-06 18:02:34,10559,281,44.29,10840,70,10910,23841,45.76,1,1,21,21,阿蓮區
2880,2020-06-06 18:02:34,10600,315,41.54,10915,59,10974,25515,43.01,1,1,21,21,茄萣區
2881,2020-06-06 18:02:34,16254,507,49.89,16761,95,16856,32578,51.74,1,1,31,31,橋頭區
2882,2020-06-06 18:02:34,2552,92,39.72,2644,21,2665,6425,41.48,1,1,12,12,田寮區
2883,2020-06-06 18:02:34,10618,306,41.88,10924,91,11015,25354,43.44,1,1,25,25,燕巢區
2884,2020-06-06 18:02:34,4914,122,42.0,5036,23,5059,11699,43.24,1,1,12,12,永安區
2885,2020-06-06 18:02:34,18054,568,42.55,18622,111,18733,42432,44.15,1,1,41,41,路竹區
2886,2020-06-06 18:02:34,10929,369,43.55,11298,75,11373,25097,45.32,1,1,24,24,湖內區
2887,2020-06-06 18:02:35,201,24,6.01,225,2,227,3342,6.79,1,1,8,8,桃源區
2888,2020-06-06 18:02:35,9749,420,28.58,10169,88,10257,34112,30.07,1,1,32,32,美濃區
2889,2020-06-06 18:02:35,1223,56,23.41,1279,16,1295,5224,24.79,1,1,7,7,甲仙區
2890,2020-06-06 18:02:35,3863,145,30.86,4008,56,4064,12517,32.47,1,1,18,18,內門區
2891,2020-06-06 18:02:35,11399,474,37.0,11873,78,11951,30807,38.79,1,1,35,35,旗山區
2892,2020-06-06 18:02:35,6173,193,38.78,6366,48,6414,15918,40.29,1,1,18,18,彌陀區
2893,2020-06-06 18:02:35,60,1,3.95,61,0,61,1520,4.01,1,1,3,3,茂林區
2894,2020-06-06 18:02:35,14032,404,46.35,14436,87,14523,30272,47.98,1,1,28,28,梓官區
2895,2020-06-06 18:02:35,2880,164,26.41,3044,40,3084,10903,28.29,1,1,12,12,六龜區
2896,2020-06-06 18:02:35,2733,121,26.69,2854,28,2882,10238,28.15,1,1,10,10,杉林區
2897,2020-06-06 18:02:36,209,7,8.95,216,0,216,2334,9.25,1,1,4,4,那瑪夏區
2898,2020-06-06 18:03:26,931914,24875,40.52,956789,5082,961871,2282836,42.13,38,34,1823,1812,高雄市
2899,2020-06-06 18:03:26,9107,221,43.17,9328,57,9385,21094,44.49,1,1,24,24,鹽埕區
2900,2020-06-06 18:03:26,43805,995,38.62,44800,186,44986,111615,40.3,1,0,77,76,鼓山區
2901,2020-06-06 18:03:27,57508,1416,36.37,58924,271,59195,158116,37.44,1,1,103,103,左營區
2902,2020-06-06 18:03:27,66816,1779,42.48,68595,347,68942,157294,43.83,1,1,119,119,前鎮區
2903,2020-06-06 18:03:27,118036,2843,41.96,120879,558,121437,276026,43.99,1,0,189,186,三民區
2904,2020-06-06 18:03:27,57069,1421,39.98,58490,295,58785,142733,41.19,1,1,116,116,苓雅區
2905,2020-06-06 18:03:27,61389,1623,40.51,63012,283,63295,151524,41.77,1,1,99,99,楠梓區
2906,2020-06-06 18:03:27,115466,2984,39.26,118450,602,119052,288251,41.3,1,0,228,224,鳳山區
2907,2020-06-06 18:03:27,9437,252,39.81,9689,47,9736,23704,41.07,1,1,22,22,前金區
2908,2020-06-06 18:03:27,10658,295,44.49,10953,58,11011,23954,45.97,1,1,18,18,旗津區
2909,2020-06-06 18:03:27,55361,1415,42.72,56776,259,57035,129597,44.01,1,1,89,89,小港區
2910,2020-06-06 18:03:27,17452,443,40.21,17895,96,17991,43397,41.46,1,1,42,42,新興區
2911,2020-06-06 18:03:28,32084,895,40.55,32979,190,33169,79113,41.93,1,1,72,72,岡山區
2912,2020-06-06 18:03:28,10618,306,41.88,10924,91,11015,25354,43.44,1,1,25,25,燕巢區
2913,2020-06-06 18:03:28,37609,990,39.59,38599,214,38813,90736,42.78,1,0,81,78,大寮區
2914,2020-06-06 18:03:28,16254,507,49.89,16761,95,16856,32578,51.74,1,1,31,31,橋頭區
2915,2020-06-06 18:03:28,32787,886,44.32,33673,168,33841,73973,45.75,1,1,47,47,仁武區
2916,2020-06-06 18:03:28,16662,412,42.76,17074,91,17165,38963,44.05,1,1,28,28,鳥松區
2917,2020-06-06 18:03:28,15318,389,42.88,15707,89,15796,35719,44.22,1,1,32,32,大樹區
2918,2020-06-06 18:03:28,25028,684,43.44,25712,194,25906,57617,44.96,1,1,51,51,林園區
2919,2020-06-06 18:03:28,13320,363,45.49,13683,89,13772,29282,47.03,1,1,24,24,大社區
2920,2020-06-06 18:03:29,10559,281,44.29,10840,70,10910,23841,45.76,1,1,21,21,阿蓮區
2921,2020-06-06 18:03:29,2552,92,39.72,2644,21,2665,6425,41.48,1,1,12,12,田寮區
2922,2020-06-06 18:03:29,18054,568,42.55,18622,111,18733,42432,44.15,1,1,41,41,路竹區
2923,2020-06-06 18:03:30,1223,56,23.41,1279,16,1295,5224,24.79,1,1,7,7,甲仙區
2924,2020-06-06 18:03:30,10929,369,43.55,11298,75,11373,25097,45.32,1,1,24,24,湖內區
2925,2020-06-06 18:03:30,10600,315,41.54,10915,59,10974,25515,43.01,1,1,21,21,茄萣區
2926,2020-06-06 18:03:30,11399,474,37.0,11873,78,11951,30807,38.79,1,1,35,35,旗山區
2927,2020-06-06 18:03:30,14032,404,46.35,14436,87,14523,30272,47.98,1,1,28,28,梓官區
2928,2020-06-06 18:03:30,6173,193,38.78,6366,48,6414,15918,40.29,1,1,18,18,彌陀區
2929,2020-06-06 18:03:30,9749,420,28.58,10169,88,10257,34112,30.07,1,1,32,32,美濃區
2930,2020-06-06 18:03:30,4914,122,42.0,5036,23,5059,11699,43.24,1,1,12,12,永安區
2931,2020-06-06 18:03:30,2880,164,26.41,3044,40,3084,10903,28.29,1,1,12,12,六龜區
2932,2020-06-06 18:03:31,201,24,6.01,225,2,227,3342,6.79,1,1,8,8,桃源區
2933,2020-06-06 18:03:31,2733,121,26.69,2854,28,2882,10238,28.15,1,1,10,10,杉林區
2934,2020-06-06 18:03:31,3863,145,30.86,4008,56,4064,12517,32.47,1,1,18,18,內門區
2935,2020-06-06 18:03:31,60,1,3.95,61,0,61,1520,4.01,1,1,3,3,茂林區
2936,2020-06-06 18:03:31,209,7,8.95,216,0,216,2334,9.25,1,1,4,4,那瑪夏區
2937,2020-06-06 18:04:21,61389,1623,40.51,63012,283,63295,151524,41.77,1,1,99,99,楠梓區
2938,2020-06-06 18:04:21,43805,995,38.62,44800,186,44986,111615,40.3,1,0,77,76,鼓山區
2939,2020-06-06 18:04:21,9107,221,43.17,9328,57,9385,21094,44.49,1,1,24,24,鹽埕區
2940,2020-06-06 18:04:21,57508,1416,36.37,58924,271,59195,158116,37.44,1,1,103,103,左營區
2941,2020-06-06 18:04:21,931914,24875,40.52,956789,5082,961871,2282836,42.13,38,34,1823,1812,高雄市
2942,2020-06-06 18:04:22,37609,990,39.59,38599,214,38813,90736,42.78,1,0,81,78,大寮區
2943,2020-06-06 18:04:22,10658,295,44.49,10953,58,11011,23954,45.97,1,1,18,18,旗津區
2944,2020-06-06 18:04:22,57069,1421,39.98,58490,295,58785,142733,41.19,1,1,116,116,苓雅區
2945,2020-06-06 18:04:22,17452,443,40.21,17895,96,17991,43397,41.46,1,1,42,42,新興區
2946,2020-06-06 18:04:22,66816,1779,42.48,68595,347,68942,157294,43.83,1,1,119,119,前鎮區
2947,2020-06-06 18:04:22,25028,684,43.44,25712,194,25906,57617,44.96,1,1,51,51,林園區
2948,2020-06-06 18:04:22,118036,2843,41.96,120879,558,121437,276026,43.99,1,0,189,186,三民區
2949,2020-06-06 18:04:22,55361,1415,42.72,56776,259,57035,129597,44.01,1,1,89,89,小港區
2950,2020-06-06 18:04:22,9437,252,39.81,9689,47,9736,23704,41.07,1,1,22,22,前金區
2951,2020-06-06 18:04:22,115466,2984,39.26,118450,602,119052,288251,41.3,1,0,228,224,鳳山區
2952,2020-06-06 18:04:23,13320,363,45.49,13683,89,13772,29282,47.03,1,1,24,24,大社區
2953,2020-06-06 18:04:23,15318,389,42.88,15707,89,15796,35719,44.22,1,1,32,32,大樹區
2954,2020-06-06 18:04:24,16254,507,49.89,16761,95,16856,32578,51.74,1,1,31,31,橋頭區
2955,2020-06-06 18:04:24,18054,568,42.55,18622,111,18733,42432,44.15,1,1,41,41,路竹區
2956,2020-06-06 18:04:24,32787,886,44.32,33673,168,33841,73973,45.75,1,1,47,47,仁武區
2957,2020-06-06 18:04:24,10618,306,41.88,10924,91,11015,25354,43.44,1,1,25,25,燕巢區
2958,2020-06-06 18:04:24,16662,412,42.76,17074,91,17165,38963,44.05,1,1,28,28,鳥松區
2959,2020-06-06 18:04:24,2552,92,39.72,2644,21,2665,6425,41.48,1,1,12,12,田寮區
2960,2020-06-06 18:04:24,10559,281,44.29,10840,70,10910,23841,45.76,1,1,21,21,阿蓮區
2961,2020-06-06 18:04:24,32084,895,40.55,32979,190,33169,79113,41.93,1,1,72,72,岡山區
2962,2020-06-06 18:04:25,4914,122,42.0,5036,23,5059,11699,43.24,1,1,12,12,永安區
2963,2020-06-06 18:04:25,10600,315,41.54,10915,59,10974,25515,43.01,1,1,21,21,茄萣區
2964,2020-06-06 18:04:25,2880,164,26.41,3044,40,3084,10903,28.29,1,1,12,12,六龜區
2965,2020-06-06 18:04:25,6173,193,38.78,6366,48,6414,15918,40.29,1,1,18,18,彌陀區
2966,2020-06-06 18:04:25,11399,474,37.0,11873,78,11951,30807,38.79,1,1,35,35,旗山區
2967,2020-06-06 18:04:25,10929,369,43.55,11298,75,11373,25097,45.32,1,1,24,24,湖內區
2968,2020-06-06 18:04:25,9749,420,28.58,10169,88,10257,34112,30.07,1,1,32,32,美濃區
2969,2020-06-06 18:04:25,14032,404,46.35,14436,87,14523,30272,47.98,1,1,28,28,梓官區
2970,2020-06-06 18:04:26,3863,145,30.86,4008,56,4064,12517,32.47,1,1,18,18,內門區
2971,2020-06-06 18:04:26,2733,121,26.69,2854,28,2882,10238,28.15,1,1,10,10,杉林區
2972,2020-06-06 18:04:26,1223,56,23.41,1279,16,1295,5224,24.79,1,1,7,7,甲仙區
2973,2020-06-06 18:04:26,201,24,6.01,225,2,227,3342,6.79,1,1,8,8,桃源區
2974,2020-06-06 18:04:26,60,1,3.95,61,0,61,1520,4.01,1,1,3,3,茂林區
2975,2020-06-06 18:04:26,209,7,8.95,216,0,216,2334,9.25,1,1,4,4,那瑪夏區
2976,2020-06-06 18:05:16,931914,24875,40.52,956789,5082,961871,2282836,42.13,38,34,1823,1812,高雄市
2977,2020-06-06 18:05:16,9107,221,43.17,9328,57,9385,21094,44.49,1,1,24,24,鹽埕區
2978,2020-06-06 18:05:16,43805,995,38.62,44800,186,44986,111615,40.3,1,0,77,76,鼓山區
2979,2020-06-06 18:05:17,118036,2843,41.96,120879,558,121437,276026,43.99,1,0,189,186,三民區
2980,2020-06-06 18:05:17,66816,1779,42.48,68595,347,68942,157294,43.83,1,1,119,119,前鎮區
2981,2020-06-06 18:05:17,57508,1416,36.37,58924,271,59195,158116,37.44,1,1,103,103,左營區
2982,2020-06-06 18:05:17,25028,684,43.44,25712,194,25906,57617,44.96,1,1,51,51,林園區
2983,2020-06-06 18:05:17,115466,2984,39.26,118450,602,119052,288251,41.3,1,0,228,224,鳳山區
2984,2020-06-06 18:05:17,9437,252,39.81,9689,47,9736,23704,41.07,1,1,22,22,前金區
2985,2020-06-06 18:05:17,55361,1415,42.72,56776,259,57035,129597,44.01,1,1,89,89,小港區
2986,2020-06-06 18:05:17,57069,1421,39.98,58490,295,58785,142733,41.19,1,1,116,116,苓雅區
2987,2020-06-06 18:05:17,17452,443,40.21,17895,96,17991,43397,41.46,1,1,42,42,新興區
2988,2020-06-06 18:05:17,10658,295,44.49,10953,58,11011,23954,45.97,1,1,18,18,旗津區
2989,2020-06-06 18:05:17,61389,1623,40.51,63012,283,63295,151524,41.77,1,1,99,99,楠梓區
2990,2020-06-06 18:05:18,37609,990,39.59,38599,214,38813,90736,42.78,1,0,81,78,大寮區
2991,2020-06-06 18:05:18,10618,306,41.88,10924,91,11015,25354,43.44,1,1,25,25,燕巢區
2992,2020-06-06 18:05:18,13320,363,45.49,13683,89,13772,29282,47.03,1,1,24,24,大社區
2993,2020-06-06 18:05:18,15318,389,42.88,15707,89,15796,35719,44.22,1,1,32,32,大樹區
2994,2020-06-06 18:05:18,16662,412,42.76,17074,91,17165,38963,44.05,1,1,28,28,鳥松區
2995,2020-06-06 18:05:18,2552,92,39.72,2644,21,2665,6425,41.48,1,1,12,12,田寮區
2996,2020-06-06 18:05:18,16254,507,49.89,16761,95,16856,32578,51.74,1,1,31,31,橋頭區
2997,2020-06-06 18:05:18,32084,895,40.55,32979,190,33169,79113,41.93,1,1,72,72,岡山區
2998,2020-06-06 18:05:18,10559,281,44.29,10840,70,10910,23841,45.76,1,1,21,21,阿蓮區
2999,2020-06-06 18:05:18,18054,568,42.55,18622,111,18733,42432,44.15,1,1,41,41,路竹區
3000,2020-06-06 18:05:18,32787,886,44.32,33673,168,33841,73973,45.75,1,1,47,47,仁武區
3001,2020-06-06 18:05:19,2880,164,26.41,3044,40,3084,10903,28.29,1,1,12,12,六龜區
3002,2020-06-06 18:05:19,11399,474,37.0,11873,78,11951,30807,38.79,1,1,35,35,旗山區
3003,2020-06-06 18:05:19,6173,193,38.78,6366,48,6414,15918,40.29,1,1,18,18,彌陀區
3004,2020-06-06 18:05:19,14032,404,46.35,14436,87,14523,30272,47.98,1,1,28,28,梓官區
3005,2020-06-06 18:05:19,9749,420,28.58,10169,88,10257,34112,30.07,1,1,32,32,美濃區
3006,2020-06-06 18:05:19,10929,369,43.55,11298,75,11373,25097,45.32,1,1,24,24,湖內區
3007,2020-06-06 18:05:19,10600,315,41.54,10915,59,10974,25515,43.01,1,1,21,21,茄萣區
3008,2020-06-06 18:05:19,4914,122,42.0,5036,23,5059,11699,43.24,1,1,12,12,永安區
3009,2020-06-06 18:05:19,2733,121,26.69,2854,28,2882,10238,28.15,1,1,10,10,杉林區
3010,2020-06-06 18:05:19,1223,56,23.41,1279,16,1295,5224,24.79,1,1,7,7,甲仙區
3011,2020-06-06 18:05:20,60,1,3.95,61,0,61,1520,4.01,1,1,3,3,茂林區
3012,2020-06-06 18:05:20,201,24,6.01,225,2,227,3342,6.79,1,1,8,8,桃源區
3013,2020-06-06 18:05:20,209,7,8.95,216,0,216,2334,9.25,1,1,4,4,那瑪夏區
3014,2020-06-06 18:05:20,3863,145,30.86,4008,56,4064,12517,32.47,1,1,18,18,內門區
3015,2020-06-06 18:06:10,9107,221,43.17,9328,57,9385,21094,44.49,1,1,24,24,鹽埕區
3016,2020-06-06 18:06:10,931914,24875,40.52,956789,5082,961871,2282836,42.13,38,34,1823,1812,高雄市
3017,2020-06-06 18:06:10,43805,995,38.62,44800,186,44986,111615,40.3,1,0,77,76,鼓山區
3018,2020-06-06 18:06:11,37609,990,39.59,38599,214,38813,90736,42.78,1,0,81,78,大寮區
3019,2020-06-06 18:06:11,15318,389,42.88,15707,89,15796,35719,44.22,1,1,32,32,大樹區
3020,2020-06-06 18:06:11,57069,1421,39.98,58490,295,58785,142733,41.19,1,1,116,116,苓雅區
3021,2020-06-06 18:06:11,57508,1416,36.37,58924,271,59195,158116,37.44,1,1,103,103,左營區
3022,2020-06-06 18:06:11,17452,443,40.21,17895,96,17991,43397,41.46,1,1,42,42,新興區
3023,2020-06-06 18:06:11,115466,2984,39.26,118450,602,119052,288251,41.3,1,0,228,224,鳳山區
3024,2020-06-06 18:06:11,118036,2843,41.96,120879,558,121437,276026,43.99,1,0,189,186,三民區
3025,2020-06-06 18:06:11,25028,684,43.44,25712,194,25906,57617,44.96,1,1,51,51,林園區
3026,2020-06-06 18:06:11,55361,1415,42.72,56776,259,57035,129597,44.01,1,1,89,89,小港區
3027,2020-06-06 18:06:11,66816,1779,42.48,68595,347,68942,157294,43.83,1,1,119,119,前鎮區
3028,2020-06-06 18:06:11,10658,295,44.49,10953,58,11011,23954,45.97,1,1,18,18,旗津區
3029,2020-06-06 18:06:11,9437,252,39.81,9689,47,9736,23704,41.07,1,1,22,22,前金區
3030,2020-06-06 18:06:11,61389,1623,40.51,63012,283,63295,151524,41.77,1,1,99,99,楠梓區
3031,2020-06-06 18:06:12,32084,895,40.55,32979,190,33169,79113,41.93,1,1,72,72,岡山區
3032,2020-06-06 18:06:12,16662,412,42.76,17074,91,17165,38963,44.05,1,1,28,28,鳥松區
3033,2020-06-06 18:06:12,32787,886,44.32,33673,168,33841,73973,45.75,1,1,47,47,仁武區
3034,2020-06-06 18:06:12,13320,363,45.49,13683,89,13772,29282,47.03,1,1,24,24,大社區
3035,2020-06-06 18:06:13,16254,507,49.89,16761,95,16856,32578,51.74,1,1,31,31,橋頭區
3036,2020-06-06 18:06:13,10618,306,41.88,10924,91,11015,25354,43.44,1,1,25,25,燕巢區
3037,2020-06-06 18:06:13,2552,92,39.72,2644,21,2665,6425,41.48,1,1,12,12,田寮區
3038,2020-06-06 18:06:14,18054,568,42.55,18622,111,18733,42432,44.15,1,1,41,41,路竹區
3039,2020-06-06 18:06:14,10559,281,44.29,10840,70,10910,23841,45.76,1,1,21,21,阿蓮區
3040,2020-06-06 18:06:14,10929,369,43.55,11298,75,11373,25097,45.32,1,1,24,24,湖內區
3041,2020-06-06 18:06:15,6173,193,38.78,6366,48,6414,15918,40.29,1,1,18,18,彌陀區
3042,2020-06-06 18:06:15,10600,315,41.54,10915,59,10974,25515,43.01,1,1,21,21,茄萣區
3043,2020-06-06 18:06:15,4914,122,42.0,5036,23,5059,11699,43.24,1,1,12,12,永安區
3044,2020-06-06 18:06:16,11399,474,37.0,11873,78,11951,30807,38.79,1,1,35,35,旗山區
3045,2020-06-06 18:06:16,14032,404,46.35,14436,87,14523,30272,47.98,1,1,28,28,梓官區
3046,2020-06-06 18:06:16,9749,420,28.58,10169,88,10257,34112,30.07,1,1,32,32,美濃區
3047,2020-06-06 18:06:17,2880,164,26.41,3044,40,3084,10903,28.29,1,1,12,12,六龜區
3048,2020-06-06 18:06:17,1223,56,23.41,1279,16,1295,5224,24.79,1,1,7,7,甲仙區
3049,2020-06-06 18:06:17,2733,121,26.69,2854,28,2882,10238,28.15,1,1,10,10,杉林區
3050,2020-06-06 18:06:18,60,1,3.95,61,0,61,1520,4.01,1,1,3,3,茂林區
3051,2020-06-06 18:06:18,3863,145,30.86,4008,56,4064,12517,32.47,1,1,18,18,內門區
3052,2020-06-06 18:06:18,201,24,6.01,225,2,227,3342,6.79,1,1,8,8,桃源區
3053,2020-06-06 18:06:19,209,7,8.95,216,0,216,2334,9.25,1,1,4,4,那瑪夏區
3054,2020-06-06 18:07:09,9437,252,39.81,9689,47,9736,23704,41.07,1,1,22,22,前金區
3055,2020-06-06 18:07:09,66816,1779,42.48,68595,347,68942,157294,43.83,1,1,119,119,前鎮區
3056,2020-06-06 18:07:09,61389,1623,40.51,63012,283,63295,151524,41.77,1,1,99,99,楠梓區
3057,2020-06-06 18:07:09,9107,221,43.17,9328,57,9385,21094,44.49,1,1,24,24,鹽埕區
3058,2020-06-06 18:07:09,935857,24954,40.69,960811,5097,965908,2292109,42.14,38,36,1823,1818,高雄市
3059,2020-06-06 18:07:09,17452,443,40.21,17895,96,17991,43397,41.46,1,1,42,42,新興區
3060,2020-06-06 18:07:09,57069,1421,39.98,58490,295,58785,142733,41.19,1,1,116,116,苓雅區
3061,2020-06-06 18:07:09,119407,2870,42.45,122277,561,122838,279241,43.99,1,0,189,188,三民區
3062,2020-06-06 18:07:09,57508,1416,36.37,58924,271,59195,158116,37.44,1,1,103,103,左營區
3063,2020-06-06 18:07:09,44512,1008,39.24,45520,190,45710,113422,40.3,1,1,77,77,鼓山區
3064,2020-06-06 18:07:10,39474,1029,41.56,40503,222,40725,94987,42.87,1,1,81,81,大寮區
3065,2020-06-06 18:07:10,10559,281,44.29,10840,70,10910,23841,45.76,1,1,21,21,阿蓮區
3066,2020-06-06 18:07:10,32787,886,44.32,33673,168,33841,73973,45.75,1,1,47,47,仁武區
3067,2020-06-06 18:07:10,10658,295,44.49,10953,58,11011,23954,45.97,1,1,18,18,旗津區
3068,2020-06-06 18:07:10,16662,412,42.76,17074,91,17165,38963,44.05,1,1,28,28,鳥松區
3069,2020-06-06 18:07:10,10618,306,41.88,10924,91,11015,25354,43.44,1,1,25,25,燕巢區
3070,2020-06-06 18:07:10,25028,684,43.44,25712,194,25906,57617,44.96,1,1,51,51,林園區
3071,2020-06-06 18:07:10,13320,363,45.49,13683,89,13772,29282,47.03,1,1,24,24,大社區
3072,2020-06-06 18:07:10,16254,507,49.89,16761,95,16856,32578,51.74,1,1,31,31,橋頭區
3073,2020-06-06 18:07:10,115466,2984,39.26,118450,602,119052,288251,41.3,1,0,228,224,鳳山區
3074,2020-06-06 18:07:10,32084,895,40.55,32979,190,33169,79113,41.93,1,1,72,72,岡山區
3075,2020-06-06 18:07:10,15318,389,42.88,15707,89,15796,35719,44.22,1,1,32,32,大樹區
3076,2020-06-06 18:07:10,55361,1415,42.72,56776,259,57035,129597,44.01,1,1,89,89,小港區
3077,2020-06-06 18:07:10,2552,92,39.72,2644,21,2665,6425,41.48,1,1,12,12,田寮區
3078,2020-06-06 18:07:11,9749,420,28.58,10169,88,10257,34112,30.07,1,1,32,32,美濃區
3079,2020-06-06 18:07:11,2733,121,26.69,2854,28,2882,10238,28.15,1,1,10,10,杉林區
3080,2020-06-06 18:07:11,2880,164,26.41,3044,40,3084,10903,28.29,1,1,12,12,六龜區
3081,2020-06-06 18:07:11,6173,193,38.78,6366,48,6414,15918,40.29,1,1,18,18,彌陀區
3082,2020-06-06 18:07:11,11399,474,37.0,11873,78,11951,30807,38.79,1,1,35,35,旗山區
3083,2020-06-06 18:07:11,14032,404,46.35,14436,87,14523,30272,47.98,1,1,28,28,梓官區
3084,2020-06-06 18:07:11,18054,568,42.55,18622,111,18733,42432,44.15,1,1,41,41,路竹區
3085,2020-06-06 18:07:11,10929,369,43.55,11298,75,11373,25097,45.32,1,1,24,24,湖內區
3086,2020-06-06 18:07:11,60,1,3.95,61,0,61,1520,4.01,1,1,3,3,茂林區
3087,2020-06-06 18:07:11,1223,56,23.41,1279,16,1295,5224,24.79,1,1,7,7,甲仙區
3088,2020-06-06 18:07:11,3863,145,30.86,4008,56,4064,12517,32.47,1,1,18,18,內門區
3089,2020-06-06 18:07:11,4914,122,42.0,5036,23,5059,11699,43.24,1,1,12,12,永安區
3090,2020-06-06 18:07:11,10600,315,41.54,10915,59,10974,25515,43.01,1,1,21,21,茄萣區
3091,2020-06-06 18:07:12,209,7,8.95,216,0,216,2334,9.25,1,1,4,4,那瑪夏區
3092,2020-06-06 18:07:12,201,24,6.01,225,2,227,3342,6.79,1,1,8,8,桃源區
3093,2020-06-06 18:08:02,61389,1623,40.51,63012,283,63295,151524,41.77,1,1,99,99,楠梓區
3094,2020-06-06 18:08:02,9107,221,43.17,9328,57,9385,21094,44.49,1,1,24,24,鹽埕區
3095,2020-06-06 18:08:02,57508,1416,36.37,58924,271,59195,158116,37.44,1,1,103,103,左營區
3096,2020-06-06 18:08:02,935857,24954,40.69,960811,5097,965908,2292109,42.14,38,36,1823,1818,高雄市
3097,2020-06-06 18:08:02,119407,2870,42.45,122277,561,122838,279241,43.99,1,0,189,188,三民區
3098,2020-06-06 18:08:02,44512,1008,39.24,45520,190,45710,113422,40.3,1,1,77,77,鼓山區
3099,2020-06-06 18:08:03,39474,1029,41.56,40503,222,40725,94987,42.87,1,1,81,81,大寮區
3100,2020-06-06 18:08:03,115466,2984,39.26,118450,602,119052,288251,41.3,1,0,228,224,鳳山區
3101,2020-06-06 18:08:03,57069,1421,39.98,58490,295,58785,142733,41.19,1,1,116,116,苓雅區
3102,2020-06-06 18:08:03,10658,295,44.49,10953,58,11011,23954,45.97,1,1,18,18,旗津區
3103,2020-06-06 18:08:03,55361,1415,42.72,56776,259,57035,129597,44.01,1,1,89,89,小港區
3104,2020-06-06 18:08:03,15318,389,42.88,15707,89,15796,35719,44.22,1,1,32,32,大樹區
3105,2020-06-06 18:08:03,25028,684,43.44,25712,194,25906,57617,44.96,1,1,51,51,林園區
3106,2020-06-06 18:08:03,66816,1779,42.48,68595,347,68942,157294,43.83,1,1,119,119,前鎮區
3107,2020-06-06 18:08:03,17452,443,40.21,17895,96,17991,43397,41.46,1,1,42,42,新興區
3108,2020-06-06 18:08:03,9437,252,39.81,9689,47,9736,23704,41.07,1,1,22,22,前金區
3109,2020-06-06 18:08:04,13320,363,45.49,13683,89,13772,29282,47.03,1,1,24,24,大社區
3110,2020-06-06 18:08:04,10559,281,44.29,10840,70,10910,23841,45.76,1,1,21,21,阿蓮區
3111,2020-06-06 18:08:04,16254,507,49.89,16761,95,16856,32578,51.74,1,1,31,31,橋頭區
3112,2020-06-06 18:08:04,18054,568,42.55,18622,111,18733,42432,44.15,1,1,41,41,路竹區
3113,2020-06-06 18:08:04,16662,412,42.76,17074,91,17165,38963,44.05,1,1,28,28,鳥松區
3114,2020-06-06 18:08:04,10618,306,41.88,10924,91,11015,25354,43.44,1,1,25,25,燕巢區
3115,2020-06-06 18:08:04,32084,895,40.55,32979,190,33169,79113,41.93,1,1,72,72,岡山區
3116,2020-06-06 18:08:04,2552,92,39.72,2644,21,2665,6425,41.48,1,1,12,12,田寮區
3117,2020-06-06 18:08:04,32787,886,44.32,33673,168,33841,73973,45.75,1,1,47,47,仁武區
3118,2020-06-06 18:08:05,10929,369,43.55,11298,75,11373,25097,45.32,1,1,24,24,湖內區
3119,2020-06-06 18:08:05,4914,122,42.0,5036,23,5059,11699,43.24,1,1,12,12,永安區
3120,2020-06-06 18:08:05,14032,404,46.35,14436,87,14523,30272,47.98,1,1,28,28,梓官區
3121,2020-06-06 18:08:05,9749,420,28.58,10169,88,10257,34112,30.07,1,1,32,32,美濃區
3122,2020-06-06 18:08:05,10600,315,41.54,10915,59,10974,25515,43.01,1,1,21,21,茄萣區
3123,2020-06-06 18:08:05,6173,193,38.78,6366,48,6414,15918,40.29,1,1,18,18,彌陀區
3124,2020-06-06 18:08:05,11399,474,37.0,11873,78,11951,30807,38.79,1,1,35,35,旗山區
3125,2020-06-06 18:08:06,201,24,6.01,225,2,227,3342,6.79,1,1,8,8,桃源區
3126,2020-06-06 18:08:06,60,1,3.95,61,0,61,1520,4.01,1,1,3,3,茂林區
3127,2020-06-06 18:08:06,3863,145,30.86,4008,56,4064,12517,32.47,1,1,18,18,內門區
3128,2020-06-06 18:08:06,1223,56,23.41,1279,16,1295,5224,24.79,1,1,7,7,甲仙區
3129,2020-06-06 18:08:06,2880,164,26.41,3044,40,3084,10903,28.29,1,1,12,12,六龜區
3130,2020-06-06 18:08:06,209,7,8.95,216,0,216,2334,9.25,1,1,4,4,那瑪夏區
3131,2020-06-06 18:08:06,2733,121,26.69,2854,28,2882,10238,28.15,1,1,10,10,杉林區
3132,2020-06-06 18:08:56,935857,24954,40.69,960811,5097,965908,2292109,42.14,38,36,1823,1818,高雄市
3133,2020-06-06 18:08:56,9107,221,43.17,9328,57,9385,21094,44.49,1,1,24,24,鹽埕區
3134,2020-06-06 18:08:57,17452,443,40.21,17895,96,17991,43397,41.46,1,1,42,42,新興區
3135,2020-06-06 18:08:57,61389,1623,40.51,63012,283,63295,151524,41.77,1,1,99,99,楠梓區
3136,2020-06-06 18:08:57,119407,2870,42.45,122277,561,122838,279241,43.99,1,0,189,188,三民區
3137,2020-06-06 18:08:57,66816,1779,42.48,68595,347,68942,157294,43.83,1,1,119,119,前鎮區
3138,2020-06-06 18:08:57,44512,1008,39.24,45520,190,45710,113422,40.3,1,1,77,77,鼓山區
3139,2020-06-06 18:08:57,9437,252,39.81,9689,47,9736,23704,41.07,1,1,22,22,前金區
3140,2020-06-06 18:08:57,57508,1416,36.37,58924,271,59195,158116,37.44,1,1,103,103,左營區
3141,2020-06-06 18:08:57,57069,1421,39.98,58490,295,58785,142733,41.19,1,1,116,116,苓雅區
3142,2020-06-06 18:08:58,115466,2984,39.26,118450,602,119052,288251,41.3,1,0,228,224,鳳山區
3143,2020-06-06 18:08:58,25028,684,43.44,25712,194,25906,57617,44.96,1,1,51,51,林園區
3144,2020-06-06 18:08:58,55361,1415,42.72,56776,259,57035,129597,44.01,1,1,89,89,小港區
3145,2020-06-06 18:08:58,10658,295,44.49,10953,58,11011,23954,45.97,1,1,18,18,旗津區
3146,2020-06-06 18:08:58,39474,1029,41.56,40503,222,40725,94987,42.87,1,1,81,81,大寮區
3147,2020-06-06 18:08:59,32787,886,44.32,33673,168,33841,73973,45.75,1,1,47,47,仁武區
3148,2020-06-06 18:08:59,13320,363,45.49,13683,89,13772,29282,47.03,1,1,24,24,大社區
3149,2020-06-06 18:08:59,15318,389,42.88,15707,89,15796,35719,44.22,1,1,32,32,大樹區
3150,2020-06-06 18:09:00,16662,412,42.76,17074,91,17165,38963,44.05,1,1,28,28,鳥松區
3151,2020-06-06 18:09:00,2552,92,39.72,2644,21,2665,6425,41.48,1,1,12,12,田寮區
3152,2020-06-06 18:09:00,16254,507,49.89,16761,95,16856,32578,51.74,1,1,31,31,橋頭區
3153,2020-06-06 18:09:00,10618,306,41.88,10924,91,11015,25354,43.44,1,1,25,25,燕巢區
3154,2020-06-06 18:09:00,6173,193,38.78,6366,48,6414,15918,40.29,1,1,18,18,彌陀區
3155,2020-06-06 18:09:00,10929,369,43.55,11298,75,11373,25097,45.32,1,1,24,24,湖內區
3156,2020-06-06 18:09:00,10600,315,41.54,10915,59,10974,25515,43.01,1,1,21,21,茄萣區
3157,2020-06-06 18:09:00,18054,568,42.55,18622,111,18733,42432,44.15,1,1,41,41,路竹區
3158,2020-06-06 18:09:00,10559,281,44.29,10840,70,10910,23841,45.76,1,1,21,21,阿蓮區
3159,2020-06-06 18:09:00,32084,895,40.55,32979,190,33169,79113,41.93,1,1,72,72,岡山區
3160,2020-06-06 18:09:00,4914,122,42.0,5036,23,5059,11699,43.24,1,1,12,12,永安區
3161,2020-06-06 18:09:01,60,1,3.95,61,0,61,1520,4.01,1,1,3,3,茂林區
3162,2020-06-06 18:09:01,1223,56,23.41,1279,16,1295,5224,24.79,1,1,7,7,甲仙區
3163,2020-06-06 18:09:01,2880,164,26.41,3044,40,3084,10903,28.29,1,1,12,12,六龜區
3164,2020-06-06 18:09:01,14032,404,46.35,14436,87,14523,30272,47.98,1,1,28,28,梓官區
3165,2020-06-06 18:09:01,209,7,8.95,216,0,216,2334,9.25,1,1,4,4,那瑪夏區
3166,2020-06-06 18:09:01,201,24,6.01,225,2,227,3342,6.79,1,1,8,8,桃源區
3167,2020-06-06 18:09:01,9749,420,28.58,10169,88,10257,34112,30.07,1,1,32,32,美濃區
3168,2020-06-06 18:09:01,3863,145,30.86,4008,56,4064,12517,32.47,1,1,18,18,內門區
3169,2020-06-06 18:09:01,2733,121,26.69,2854,28,2882,10238,28.15,1,1,10,10,杉林區
3170,2020-06-06 18:09:01,11399,474,37.0,11873,78,11951,30807,38.79,1,1,35,35,旗山區
3171,2020-06-06 18:09:51,44512,1008,39.24,45520,190,45710,113422,40.3,1,1,77,77,鼓山區
3172,2020-06-06 18:09:51,57508,1416,36.37,58924,271,59195,158116,37.44,1,1,103,103,左營區
3173,2020-06-06 18:09:51,9107,221,43.17,9328,57,9385,21094,44.49,1,1,24,24,鹽埕區
3174,2020-06-06 18:09:51,937112,24992,40.74,962104,5104,967208,2295342,42.14,38,36,1823,1820,高雄市
3175,2020-06-06 18:09:52,25028,684,43.44,25712,194,25906,57617,44.96,1,1,51,51,林園區
3176,2020-06-06 18:09:52,66816,1779,42.48,68595,347,68942,157294,43.83,1,1,119,119,前鎮區
3177,2020-06-06 18:09:52,17452,443,40.21,17895,96,17991,43397,41.46,1,1,42,42,新興區
3178,2020-06-06 18:09:52,116721,3022,39.69,119743,609,120352,291484,41.29,1,0,228,226,鳳山區
3179,2020-06-06 18:09:52,39474,1029,41.56,40503,222,40725,94987,42.87,1,1,81,81,大寮區
3180,2020-06-06 18:09:52,10618,306,41.88,10924,91,11015,25354,43.44,1,1,25,25,燕巢區
3181,2020-06-06 18:09:52,9437,252,39.81,9689,47,9736,23704,41.07,1,1,22,22,前金區
3182,2020-06-06 18:09:52,32084,895,40.55,32979,190,33169,79113,41.93,1,1,72,72,岡山區
3183,2020-06-06 18:09:52,16254,507,49.89,16761,95,16856,32578,51.74,1,1,31,31,橋頭區
3184,2020-06-06 18:09:52,16662,412,42.76,17074,91,17165,38963,44.05,1,1,28,28,鳥松區
3185,2020-06-06 18:09:52,55361,1415,42.72,56776,259,57035,129597,44.01,1,1,89,89,小港區
3186,2020-06-06 18:09:52,61389,1623,40.51,63012,283,63295,151524,41.77,1,1,99,99,楠梓區
3187,2020-06-06 18:09:52,13320,363,45.49,13683,89,13772,29282,47.03,1,1,24,24,大社區
3188,2020-06-06 18:09:52,32787,886,44.32,33673,168,33841,73973,45.75,1,1,47,47,仁武區
3189,2020-06-06 18:09:52,10658,295,44.49,10953,58,11011,23954,45.97,1,1,18,18,旗津區
3190,2020-06-06 18:09:52,119407,2870,42.45,122277,561,122838,279241,43.99,1,0,189,188,三民區
3191,2020-06-06 18:09:52,57069,1421,39.98,58490,295,58785,142733,41.19,1,1,116,116,苓雅區
3192,2020-06-06 18:09:52,15318,389,42.88,15707,89,15796,35719,44.22,1,1,32,32,大樹區
3193,2020-06-06 18:09:53,9749,420,28.58,10169,88,10257,34112,30.07,1,1,32,32,美濃區
3194,2020-06-06 18:09:53,4914,122,42.0,5036,23,5059,11699,43.24,1,1,12,12,永安區
3195,2020-06-06 18:09:53,2552,92,39.72,2644,21,2665,6425,41.48,1,1,12,12,田寮區
3196,2020-06-06 18:09:53,2733,121,26.69,2854,28,2882,10238,28.15,1,1,10,10,杉林區
3197,2020-06-06 18:09:53,14032,404,46.35,14436,87,14523,30272,47.98,1,1,28,28,梓官區
3198,2020-06-06 18:09:53,1223,56,23.41,1279,16,1295,5224,24.79,1,1,7,7,甲仙區
3199,2020-06-06 18:09:53,10600,315,41.54,10915,59,10974,25515,43.01,1,1,21,21,茄萣區
3200,2020-06-06 18:09:53,6173,193,38.78,6366,48,6414,15918,40.29,1,1,18,18,彌陀區
3201,2020-06-06 18:09:53,10929,369,43.55,11298,75,11373,25097,45.32,1,1,24,24,湖內區
3202,2020-06-06 18:09:53,2880,164,26.41,3044,40,3084,10903,28.29,1,1,12,12,六龜區
3203,2020-06-06 18:09:53,18054,568,42.55,18622,111,18733,42432,44.15,1,1,41,41,路竹區
3204,2020-06-06 18:09:53,10559,281,44.29,10840,70,10910,23841,45.76,1,1,21,21,阿蓮區
3205,2020-06-06 18:09:53,11399,474,37.0,11873,78,11951,30807,38.79,1,1,35,35,旗山區
3206,2020-06-06 18:09:54,60,1,3.95,61,0,61,1520,4.01,1,1,3,3,茂林區
3207,2020-06-06 18:09:54,201,24,6.01,225,2,227,3342,6.79,1,1,8,8,桃源區
3208,2020-06-06 18:09:54,209,7,8.95,216,0,216,2334,9.25,1,1,4,4,那瑪夏區
3209,2020-06-06 18:09:54,3863,145,30.86,4008,56,4064,12517,32.47,1,1,18,18,內門區
3210,2020-06-06 18:10:44,44512,1008,39.24,45520,190,45710,113422,40.3,1,1,77,77,鼓山區
3211,2020-06-06 18:10:44,9107,221,43.17,9328,57,9385,21094,44.49,1,1,24,24,鹽埕區
3212,2020-06-06 18:10:44,937112,24992,40.74,962104,5104,967208,2295342,42.14,38,36,1823,1820,高雄市
3213,2020-06-06 18:10:44,61389,1623,40.51,63012,283,63295,151524,41.77,1,1,99,99,楠梓區
3214,2020-06-06 18:10:44,119407,2870,42.45,122277,561,122838,279241,43.99,1,0,189,188,三民區
3215,2020-06-06 18:10:44,17452,443,40.21,17895,96,17991,43397,41.46,1,1,42,42,新興區
3216,2020-06-06 18:10:44,57508,1416,36.37,58924,271,59195,158116,37.44,1,1,103,103,左營區
3217,2020-06-06 18:10:45,10658,295,44.49,10953,58,11011,23954,45.97,1,1,18,18,旗津區
3218,2020-06-06 18:10:45,66816,1779,42.48,68595,347,68942,157294,43.83,1,1,119,119,前鎮區
3219,2020-06-06 18:10:45,13320,363,45.49,13683,89,13772,29282,47.03,1,1,24,24,大社區
3220,2020-06-06 18:10:45,57069,1421,39.98,58490,295,58785,142733,41.19,1,1,116,116,苓雅區
3221,2020-06-06 18:10:45,32787,886,44.32,33673,168,33841,73973,45.75,1,1,47,47,仁武區
3222,2020-06-06 18:10:45,116721,3022,39.69,119743,609,120352,291484,41.29,1,0,228,226,鳳山區
3223,2020-06-06 18:10:45,39474,1029,41.56,40503,222,40725,94987,42.87,1,1,81,81,大寮區
3224,2020-06-06 18:10:45,25028,684,43.44,25712,194,25906,57617,44.96,1,1,51,51,林園區
3225,2020-06-06 18:10:45,9437,252,39.81,9689,47,9736,23704,41.07,1,1,22,22,前金區
3226,2020-06-06 18:10:45,15318,389,42.88,15707,89,15796,35719,44.22,1,1,32,32,大樹區
3227,2020-06-06 18:10:45,55361,1415,42.72,56776,259,57035,129597,44.01,1,1,89,89,小港區
3228,2020-06-06 18:10:46,10929,369,43.55,11298,75,11373,25097,45.32,1,1,24,24,湖內區
3229,2020-06-06 18:10:46,10559,281,44.29,10840,70,10910,23841,45.76,1,1,21,21,阿蓮區
3230,2020-06-06 18:10:46,16662,412,42.76,17074,91,17165,38963,44.05,1,1,28,28,鳥松區
3231,2020-06-06 18:10:46,10618,306,41.88,10924,91,11015,25354,43.44,1,1,25,25,燕巢區
3232,2020-06-06 18:10:46,32084,895,40.55,32979,190,33169,79113,41.93,1,1,72,72,岡山區
3233,2020-06-06 18:10:46,18054,568,42.55,18622,111,18733,42432,44.15,1,1,41,41,路竹區
3234,2020-06-06 18:10:46,16254,507,49.89,16761,95,16856,32578,51.74,1,1,31,31,橋頭區
3235,2020-06-06 18:10:46,10600,315,41.54,10915,59,10974,25515,43.01,1,1,21,21,茄萣區
3236,2020-06-06 18:10:46,2552,92,39.72,2644,21,2665,6425,41.48,1,1,12,12,田寮區
3237,2020-06-06 18:10:47,6173,193,38.78,6366,48,6414,15918,40.29,1,1,18,18,彌陀區
3238,2020-06-06 18:10:47,2880,164,26.41,3044,40,3084,10903,28.29,1,1,12,12,六龜區
3239,2020-06-06 18:10:47,14032,404,46.35,14436,87,14523,30272,47.98,1,1,28,28,梓官區
3240,2020-06-06 18:10:47,4914,122,42.0,5036,23,5059,11699,43.24,1,1,12,12,永安區
3241,2020-06-06 18:10:47,9749,420,28.58,10169,88,10257,34112,30.07,1,1,32,32,美濃區
3242,2020-06-06 18:10:47,11399,474,37.0,11873,78,11951,30807,38.79,1,1,35,35,旗山區
3243,2020-06-06 18:10:48,201,24,6.01,225,2,227,3342,6.79,1,1,8,8,桃源區
3244,2020-06-06 18:10:48,60,1,3.95,61,0,61,1520,4.01,1,1,3,3,茂林區
3245,2020-06-06 18:10:48,3863,145,30.86,4008,56,4064,12517,32.47,1,1,18,18,內門區
3246,2020-06-06 18:10:48,209,7,8.95,216,0,216,2334,9.25,1,1,4,4,那瑪夏區
3247,2020-06-06 18:10:48,1223,56,23.41,1279,16,1295,5224,24.79,1,1,7,7,甲仙區
3248,2020-06-06 18:10:48,2733,121,26.69,2854,28,2882,10238,28.15,1,1,10,10,杉林區
3249,2020-06-06 18:11:38,119407,2870,42.45,122277,561,122838,279241,43.99,1,0,189,188,三民區
3250,2020-06-06 18:11:38,17452,443,40.21,17895,96,17991,43397,41.46,1,1,42,42,新興區
3251,2020-06-06 18:11:38,57508,1416,36.37,58924,271,59195,158116,37.44,1,1,103,103,左營區
3252,2020-06-06 18:11:38,61389,1623,40.51,63012,283,63295,151524,41.77,1,1,99,99,楠梓區
3253,2020-06-06 18:11:38,937112,24992,40.74,962104,5104,967208,2295342,42.14,38,36,1823,1820,高雄市
3254,2020-06-06 18:11:38,44512,1008,39.24,45520,190,45710,113422,40.3,1,1,77,77,鼓山區
3255,2020-06-06 18:11:38,9107,221,43.17,9328,57,9385,21094,44.49,1,1,24,24,鹽埕區
3256,2020-06-06 18:11:38,9437,252,39.81,9689,47,9736,23704,41.07,1,1,22,22,前金區
3257,2020-06-06 18:11:39,10658,295,44.49,10953,58,11011,23954,45.97,1,1,18,18,旗津區
3258,2020-06-06 18:11:39,57069,1421,39.98,58490,295,58785,142733,41.19,1,1,116,116,苓雅區
3259,2020-06-06 18:11:39,66816,1779,42.48,68595,347,68942,157294,43.83,1,1,119,119,前鎮區
3260,2020-06-06 18:11:40,32084,895,40.55,32979,190,33169,79113,41.93,1,1,72,72,岡山區
3261,2020-06-06 18:11:40,16662,412,42.76,17074,91,17165,38963,44.05,1,1,28,28,鳥松區
3262,2020-06-06 18:11:40,116721,3022,39.69,119743,609,120352,291484,41.29,1,0,228,226,鳳山區
3263,2020-06-06 18:11:40,2552,92,39.72,2644,21,2665,6425,41.48,1,1,12,12,田寮區
3264,2020-06-06 18:11:40,13320,363,45.49,13683,89,13772,29282,47.03,1,1,24,24,大社區
3265,2020-06-06 18:11:40,32787,886,44.32,33673,168,33841,73973,45.75,1,1,47,47,仁武區
3266,2020-06-06 18:11:40,15318,389,42.88,15707,89,15796,35719,44.22,1,1,32,32,大樹區
3267,2020-06-06 18:11:40,55361,1415,42.72,56776,259,57035,129597,44.01,1,1,89,89,小港區
3268,2020-06-06 18:11:40,10618,306,41.88,10924,91,11015,25354,43.44,1,1,25,25,燕巢區
3269,2020-06-06 18:11:40,16254,507,49.89,16761,95,16856,32578,51.74,1,1,31,31,橋頭區
3270,2020-06-06 18:11:40,39474,1029,41.56,40503,222,40725,94987,42.87,1,1,81,81,大寮區
3271,2020-06-06 18:11:40,25028,684,43.44,25712,194,25906,57617,44.96,1,1,51,51,林園區
3272,2020-06-06 18:11:41,10559,281,44.29,10840,70,10910,23841,45.76,1,1,21,21,阿蓮區
3273,2020-06-06 18:11:41,10929,369,43.55,11298,75,11373,25097,45.32,1,1,24,24,湖內區
3274,2020-06-06 18:11:41,18054,568,42.55,18622,111,18733,42432,44.15,1,1,41,41,路竹區
3275,2020-06-06 18:11:42,14032,404,46.35,14436,87,14523,30272,47.98,1,1,28,28,梓官區
3276,2020-06-06 18:11:42,6173,193,38.78,6366,48,6414,15918,40.29,1,1,18,18,彌陀區
3277,2020-06-06 18:11:42,4914,122,42.0,5036,23,5059,11699,43.24,1,1,12,12,永安區
3278,2020-06-06 18:11:42,9749,420,28.58,10169,88,10257,34112,30.07,1,1,32,32,美濃區
3279,2020-06-06 18:11:42,11399,474,37.0,11873,78,11951,30807,38.79,1,1,35,35,旗山區
3280,2020-06-06 18:11:42,10600,315,41.54,10915,59,10974,25515,43.01,1,1,21,21,茄萣區
3281,2020-06-06 18:11:43,2733,121,26.69,2854,28,2882,10238,28.15,1,1,10,10,杉林區
3282,2020-06-06 18:11:43,1223,56,23.41,1279,16,1295,5224,24.79,1,1,7,7,甲仙區
3283,2020-06-06 18:11:43,3863,145,30.86,4008,56,4064,12517,32.47,1,1,18,18,內門區
3284,2020-06-06 18:11:43,209,7,8.95,216,0,216,2334,9.25,1,1,4,4,那瑪夏區
3285,2020-06-06 18:11:43,201,24,6.01,225,2,227,3342,6.79,1,1,8,8,桃源區
3286,2020-06-06 18:11:43,60,1,3.95,61,0,61,1520,4.01,1,1,3,3,茂林區
3287,2020-06-06 18:11:43,2880,164,26.41,3044,40,3084,10903,28.29,1,1,12,12,六龜區
3288,2020-06-06 18:12:33,937600,25013,40.77,962613,5109,967722,2296620,42.14,38,36,1823,1821,高雄市
3289,2020-06-06 18:12:33,9107,221,43.17,9328,57,9385,21094,44.49,1,1,24,24,鹽埕區
3290,2020-06-06 18:12:34,57069,1421,39.98,58490,295,58785,142733,41.19,1,1,116,116,苓雅區
3291,2020-06-06 18:12:34,10658,295,44.49,10953,58,11011,23954,45.97,1,1,18,18,旗津區
3292,2020-06-06 18:12:34,61389,1623,40.51,63012,283,63295,151524,41.77,1,1,99,99,楠梓區
3293,2020-06-06 18:12:34,55361,1415,42.72,56776,259,57035,129597,44.01,1,1,89,89,小港區
3294,2020-06-06 18:12:34,66816,1779,42.48,68595,347,68942,157294,43.83,1,1,119,119,前鎮區
3295,2020-06-06 18:12:34,119407,2870,42.45,122277,561,122838,279241,43.99,1,0,189,188,三民區
3296,2020-06-06 18:12:34,17452,443,40.21,17895,96,17991,43397,41.46,1,1,42,42,新興區
3297,2020-06-06 18:12:34,9437,252,39.81,9689,47,9736,23704,41.07,1,1,22,22,前金區
3298,2020-06-06 18:12:34,57508,1416,36.37,58924,271,59195,158116,37.44,1,1,103,103,左營區
3299,2020-06-06 18:12:34,44512,1008,39.24,45520,190,45710,113422,40.3,1,1,77,77,鼓山區
3300,2020-06-06 18:12:35,25028,684,43.44,25712,194,25906,57617,44.96,1,1,51,51,林園區
3301,2020-06-06 18:12:35,15318,389,42.88,15707,89,15796,35719,44.22,1,1,32,32,大樹區
3302,2020-06-06 18:12:35,39474,1029,41.56,40503,222,40725,94987,42.87,1,1,81,81,大寮區
3303,2020-06-06 18:12:35,117209,3043,39.86,120252,614,120866,292762,41.28,1,0,228,227,鳳山區
3304,2020-06-06 18:12:35,13320,363,45.49,13683,89,13772,29282,47.03,1,1,24,24,大社區
3305,2020-06-06 18:12:36,16662,412,42.76,17074,91,17165,38963,44.05,1,1,28,28,鳥松區
3306,2020-06-06 18:12:36,18054,568,42.55,18622,111,18733,42432,44.15,1,1,41,41,路竹區
3307,2020-06-06 18:12:36,32787,886,44.32,33673,168,33841,73973,45.75,1,1,47,47,仁武區
3308,2020-06-06 18:12:36,6173,193,38.78,6366,48,6414,15918,40.29,1,1,18,18,彌陀區
3309,2020-06-06 18:12:36,16254,507,49.89,16761,95,16856,32578,51.74,1,1,31,31,橋頭區
3310,2020-06-06 18:12:36,10600,315,41.54,10915,59,10974,25515,43.01,1,1,21,21,茄萣區
3311,2020-06-06 18:12:36,32084,895,40.55,32979,190,33169,79113,41.93,1,1,72,72,岡山區
3312,2020-06-06 18:12:36,4914,122,42.0,5036,23,5059,11699,43.24,1,1,12,12,永安區
3313,2020-06-06 18:12:36,10618,306,41.88,10924,91,11015,25354,43.44,1,1,25,25,燕巢區
3314,2020-06-06 18:12:36,10559,281,44.29,10840,70,10910,23841,45.76,1,1,21,21,阿蓮區
3315,2020-06-06 18:12:36,10929,369,43.55,11298,75,11373,25097,45.32,1,1,24,24,湖內區
3316,2020-06-06 18:12:36,2552,92,39.72,2644,21,2665,6425,41.48,1,1,12,12,田寮區
3317,2020-06-06 18:12:37,9749,420,28.58,10169,88,10257,34112,30.07,1,1,32,32,美濃區
3318,2020-06-06 18:12:37,14032,404,46.35,14436,87,14523,30272,47.98,1,1,28,28,梓官區
3319,2020-06-06 18:12:37,1223,56,23.41,1279,16,1295,5224,24.79,1,1,7,7,甲仙區
3320,2020-06-06 18:12:37,11399,474,37.0,11873,78,11951,30807,38.79,1,1,35,35,旗山區
3321,2020-06-06 18:12:37,2880,164,26.41,3044,40,3084,10903,28.29,1,1,12,12,六龜區
3322,2020-06-06 18:12:38,60,1,3.95,61,0,61,1520,4.01,1,1,3,3,茂林區
3323,2020-06-06 18:12:38,3863,145,30.86,4008,56,4064,12517,32.47,1,1,18,18,內門區
3324,2020-06-06 18:12:38,2733,121,26.69,2854,28,2882,10238,28.15,1,1,10,10,杉林區
3325,2020-06-06 18:12:39,201,24,6.01,225,2,227,3342,6.79,1,1,8,8,桃源區
3326,2020-06-06 18:12:39,209,7,8.95,216,0,216,2334,9.25,1,1,4,4,那瑪夏區
3327,2020-06-06 18:13:29,119407,2870,42.45,122277,561,122838,279241,43.99,1,0,189,188,三民區
3328,2020-06-06 18:13:29,9107,221,43.17,9328,57,9385,21094,44.49,1,1,24,24,鹽埕區
3329,2020-06-06 18:13:29,937600,25013,40.77,962613,5109,967722,2296620,42.14,38,36,1823,1821,高雄市
3330,2020-06-06 18:13:29,61389,1623,40.51,63012,283,63295,151524,41.77,1,1,99,99,楠梓區
3331,2020-06-06 18:13:29,57508,1416,36.37,58924,271,59195,158116,37.44,1,1,103,103,左營區
3332,2020-06-06 18:13:29,44512,1008,39.24,45520,190,45710,113422,40.3,1,1,77,77,鼓山區
3333,2020-06-06 18:13:30,9437,252,39.81,9689,47,9736,23704,41.07,1,1,22,22,前金區
3334,2020-06-06 18:13:30,117209,3043,39.86,120252,614,120866,292762,41.28,1,0,228,227,鳳山區
3335,2020-06-06 18:13:30,57069,1421,39.98,58490,295,58785,142733,41.19,1,1,116,116,苓雅區
3336,2020-06-06 18:13:30,17452,443,40.21,17895,96,17991,43397,41.46,1,1,42,42,新興區
3337,2020-06-06 18:13:30,55361,1415,42.72,56776,259,57035,129597,44.01,1,1,89,89,小港區
3338,2020-06-06 18:13:30,10658,295,44.49,10953,58,11011,23954,45.97,1,1,18,18,旗津區
3339,2020-06-06 18:13:30,66816,1779,42.48,68595,347,68942,157294,43.83,1,1,119,119,前鎮區
3340,2020-06-06 18:13:31,39474,1029,41.56,40503,222,40725,94987,42.87,1,1,81,81,大寮區
3341,2020-06-06 18:13:31,25028,684,43.44,25712,194,25906,57617,44.96,1,1,51,51,林園區
3342,2020-06-06 18:13:31,10618,306,41.88,10924,91,11015,25354,43.44,1,1,25,25,燕巢區
3343,2020-06-06 18:13:31,13320,363,45.49,13683,89,13772,29282,47.03,1,1,24,24,大社區
3344,2020-06-06 18:13:31,16254,507,49.89,16761,95,16856,32578,51.74,1,1,31,31,橋頭區
3345,2020-06-06 18:13:31,10600,315,41.54,10915,59,10974,25515,43.01,1,1,21,21,茄萣區
3346,2020-06-06 18:13:31,16662,412,42.76,17074,91,17165,38963,44.05,1,1,28,28,鳥松區
3347,2020-06-06 18:13:31,10929,369,43.55,11298,75,11373,25097,45.32,1,1,24,24,湖內區
3348,2020-06-06 18:13:31,32084,895,40.55,32979,190,33169,79113,41.93,1,1,72,72,岡山區
3349,2020-06-06 18:13:31,6173,193,38.78,6366,48,6414,15918,40.29,1,1,18,18,彌陀區
3350,2020-06-06 18:13:31,10559,281,44.29,10840,70,10910,23841,45.76,1,1,21,21,阿蓮區
3351,2020-06-06 18:13:31,18054,568,42.55,18622,111,18733,42432,44.15,1,1,41,41,路竹區
3352,2020-06-06 18:13:31,4914,122,42.0,5036,23,5059,11699,43.24,1,1,12,12,永安區
3353,2020-06-06 18:13:31,32787,886,44.32,33673,168,33841,73973,45.75,1,1,47,47,仁武區
3354,2020-06-06 18:13:31,2552,92,39.72,2644,21,2665,6425,41.48,1,1,12,12,田寮區
3355,2020-06-06 18:13:31,15318,389,42.88,15707,89,15796,35719,44.22,1,1,32,32,大樹區
3356,2020-06-06 18:13:32,14032,404,46.35,14436,87,14523,30272,47.98,1,1,28,28,梓官區
3357,2020-06-06 18:13:32,60,1,3.95,61,0,61,1520,4.01,1,1,3,3,茂林區
3358,2020-06-06 18:13:32,3863,145,30.86,4008,56,4064,12517,32.47,1,1,18,18,內門區
3359,2020-06-06 18:13:32,9749,420,28.58,10169,88,10257,34112,30.07,1,1,32,32,美濃區
3360,2020-06-06 18:13:32,1223,56,23.41,1279,16,1295,5224,24.79,1,1,7,7,甲仙區
3361,2020-06-06 18:13:32,11399,474,37.0,11873,78,11951,30807,38.79,1,1,35,35,旗山區
3362,2020-06-06 18:13:32,201,24,6.01,225,2,227,3342,6.79,1,1,8,8,桃源區
3363,2020-06-06 18:13:32,2733,121,26.69,2854,28,2882,10238,28.15,1,1,10,10,杉林區
3364,2020-06-06 18:13:32,2880,164,26.41,3044,40,3084,10903,28.29,1,1,12,12,六龜區
3365,2020-06-06 18:13:33,209,7,8.95,216,0,216,2334,9.25,1,1,4,4,那瑪夏區
3366,2020-06-06 18:14:23,937600,25013,40.77,962613,5109,967722,2296620,42.14,38,36,1823,1821,高雄市
3367,2020-06-06 18:14:23,57508,1416,36.37,58924,271,59195,158116,37.44,1,1,103,103,左營區
3368,2020-06-06 18:14:23,44512,1008,39.24,45520,190,45710,113422,40.3,1,1,77,77,鼓山區
3369,2020-06-06 18:14:23,61389,1623,40.51,63012,283,63295,151524,41.77,1,1,99,99,楠梓區
3370,2020-06-06 18:14:23,9107,221,43.17,9328,57,9385,21094,44.49,1,1,24,24,鹽埕區
3371,2020-06-06 18:14:24,117209,3043,39.86,120252,614,120866,292762,41.28,1,0,228,227,鳳山區
3372,2020-06-06 18:14:24,119407,2870,42.45,122277,561,122838,279241,43.99,1,0,189,188,三民區
3373,2020-06-06 18:14:24,55361,1415,42.72,56776,259,57035,129597,44.01,1,1,89,89,小港區
3374,2020-06-06 18:14:24,9437,252,39.81,9689,47,9736,23704,41.07,1,1,22,22,前金區
3375,2020-06-06 18:14:24,57069,1421,39.98,58490,295,58785,142733,41.19,1,1,116,116,苓雅區
3376,2020-06-06 18:14:24,13320,363,45.49,13683,89,13772,29282,47.03,1,1,24,24,大社區
3377,2020-06-06 18:14:24,15318,389,42.88,15707,89,15796,35719,44.22,1,1,32,32,大樹區
3378,2020-06-06 18:14:24,39474,1029,41.56,40503,222,40725,94987,42.87,1,1,81,81,大寮區
3379,2020-06-06 18:14:24,10658,295,44.49,10953,58,11011,23954,45.97,1,1,18,18,旗津區
3380,2020-06-06 18:14:24,25028,684,43.44,25712,194,25906,57617,44.96,1,1,51,51,林園區
3381,2020-06-06 18:14:24,17452,443,40.21,17895,96,17991,43397,41.46,1,1,42,42,新興區
3382,2020-06-06 18:14:24,66816,1779,42.48,68595,347,68942,157294,43.83,1,1,119,119,前鎮區
3383,2020-06-06 18:14:24,32787,886,44.32,33673,168,33841,73973,45.75,1,1,47,47,仁武區
3384,2020-06-06 18:14:25,16254,507,49.89,16761,95,16856,32578,51.74,1,1,31,31,橋頭區
3385,2020-06-06 18:14:25,32084,895,40.55,32979,190,33169,79113,41.93,1,1,72,72,岡山區
3386,2020-06-06 18:14:25,10618,306,41.88,10924,91,11015,25354,43.44,1,1,25,25,燕巢區
3387,2020-06-06 18:14:25,16662,412,42.76,17074,91,17165,38963,44.05,1,1,28,28,鳥松區
3388,2020-06-06 18:14:25,2552,92,39.72,2644,21,2665,6425,41.48,1,1,12,12,田寮區
3389,2020-06-06 18:14:26,18054,568,42.55,18622,111,18733,42432,44.15,1,1,41,41,路竹區
3390,2020-06-06 18:14:26,10929,369,43.55,11298,75,11373,25097,45.32,1,1,24,24,湖內區
3391,2020-06-06 18:14:26,10559,281,44.29,10840,70,10910,23841,45.76,1,1,21,21,阿蓮區
3392,2020-06-06 18:14:26,4914,122,42.0,5036,23,5059,11699,43.24,1,1,12,12,永安區
3393,2020-06-06 18:14:26,10600,315,41.54,10915,59,10974,25515,43.01,1,1,21,21,茄萣區
3394,2020-06-06 18:14:27,3863,145,30.86,4008,56,4064,12517,32.47,1,1,18,18,內門區
3395,2020-06-06 18:14:27,2733,121,26.69,2854,28,2882,10238,28.15,1,1,10,10,杉林區
3396,2020-06-06 18:14:27,1223,56,23.41,1279,16,1295,5224,24.79,1,1,7,7,甲仙區
3397,2020-06-06 18:14:27,11399,474,37.0,11873,78,11951,30807,38.79,1,1,35,35,旗山區
3398,2020-06-06 18:14:27,6173,193,38.78,6366,48,6414,15918,40.29,1,1,18,18,彌陀區
3399,2020-06-06 18:14:27,14032,404,46.35,14436,87,14523,30272,47.98,1,1,28,28,梓官區
3400,2020-06-06 18:14:27,9749,420,28.58,10169,88,10257,34112,30.07,1,1,32,32,美濃區
3401,2020-06-06 18:14:27,60,1,3.95,61,0,61,1520,4.01,1,1,3,3,茂林區
3402,2020-06-06 18:14:27,2880,164,26.41,3044,40,3084,10903,28.29,1,1,12,12,六龜區
3403,2020-06-06 18:14:28,209,7,8.95,216,0,216,2334,9.25,1,1,4,4,那瑪夏區
3404,2020-06-06 18:14:28,201,24,6.01,225,2,227,3342,6.79,1,1,8,8,桃源區
3405,2020-06-06 18:15:18,44512,1008,39.24,45520,190,45710,113422,40.3,1,1,77,77,鼓山區
3406,2020-06-06 18:15:18,9107,221,43.17,9328,57,9385,21094,44.49,1,1,24,24,鹽埕區
3407,2020-06-06 18:15:18,938186,25032,40.79,963218,5112,968330,2297941,42.14,38,37,1823,1822,高雄市
3408,2020-06-06 18:15:19,57508,1416,36.37,58924,271,59195,158116,37.44,1,1,103,103,左營區
3409,2020-06-06 18:15:19,61389,1623,40.51,63012,283,63295,151524,41.77,1,1,99,99,楠梓區
3410,2020-06-06 18:15:19,17452,443,40.21,17895,96,17991,43397,41.46,1,1,42,42,新興區
3411,2020-06-06 18:15:19,119407,2870,42.45,122277,561,122838,279241,43.99,1,0,189,188,三民區
3412,2020-06-06 18:15:20,9437,252,39.81,9689,47,9736,23704,41.07,1,1,22,22,前金區
3413,2020-06-06 18:15:20,57069,1421,39.98,58490,295,58785,142733,41.19,1,1,116,116,苓雅區
3414,2020-06-06 18:15:20,66816,1779,42.48,68595,347,68942,157294,43.83,1,1,119,119,前鎮區
3415,2020-06-06 18:15:21,55361,1415,42.72,56776,259,57035,129597,44.01,1,1,89,89,小港區
3416,2020-06-06 18:15:21,10658,295,44.49,10953,58,11011,23954,45.97,1,1,18,18,旗津區
3417,2020-06-06 18:15:21,117795,3062,40.06,120857,617,121474,294083,41.31,1,1,228,228,鳳山區
3418,2020-06-06 18:15:22,13320,363,45.49,13683,89,13772,29282,47.03,1,1,24,24,大社區
3419,2020-06-06 18:15:22,39474,1029,41.56,40503,222,40725,94987,42.87,1,1,81,81,大寮區
3420,2020-06-06 18:15:22,25028,684,43.44,25712,194,25906,57617,44.96,1,1,51,51,林園區
3421,2020-06-06 18:15:22,15318,389,42.88,15707,89,15796,35719,44.22,1,1,32,32,大樹區
3422,2020-06-06 18:15:23,16662,412,42.76,17074,91,17165,38963,44.05,1,1,28,28,鳥松區
3423,2020-06-06 18:15:23,10618,306,41.88,10924,91,11015,25354,43.44,1,1,25,25,燕巢區
3424,2020-06-06 18:15:23,32787,886,44.32,33673,168,33841,73973,45.75,1,1,47,47,仁武區
3425,2020-06-06 18:15:23,16254,507,49.89,16761,95,16856,32578,51.74,1,1,31,31,橋頭區
3426,2020-06-06 18:15:23,32084,895,40.55,32979,190,33169,79113,41.93,1,1,72,72,岡山區
3427,2020-06-06 18:15:24,10559,281,44.29,10840,70,10910,23841,45.76,1,1,21,21,阿蓮區
3428,2020-06-06 18:15:24,2552,92,39.72,2644,21,2665,6425,41.48,1,1,12,12,田寮區
3429,2020-06-06 18:15:24,18054,568,42.55,18622,111,18733,42432,44.15,1,1,41,41,路竹區
3430,2020-06-06 18:15:24,10929,369,43.55,11298,75,11373,25097,45.32,1,1,24,24,湖內區
3431,2020-06-06 18:15:25,4914,122,42.0,5036,23,5059,11699,43.24,1,1,12,12,永安區
3432,2020-06-06 18:15:25,10600,315,41.54,10915,59,10974,25515,43.01,1,1,21,21,茄萣區
3433,2020-06-06 18:15:25,6173,193,38.78,6366,48,6414,15918,40.29,1,1,18,18,彌陀區
3434,2020-06-06 18:15:26,14032,404,46.35,14436,87,14523,30272,47.98,1,1,28,28,梓官區
3435,2020-06-06 18:15:26,11399,474,37.0,11873,78,11951,30807,38.79,1,1,35,35,旗山區
3436,2020-06-06 18:15:27,9749,420,28.58,10169,88,10257,34112,30.07,1,1,32,32,美濃區
3437,2020-06-06 18:15:28,3863,145,30.86,4008,56,4064,12517,32.47,1,1,18,18,內門區
3438,2020-06-06 18:15:28,2733,121,26.69,2854,28,2882,10238,28.15,1,1,10,10,杉林區
3439,2020-06-06 18:15:28,1223,56,23.41,1279,16,1295,5224,24.79,1,1,7,7,甲仙區
3440,2020-06-06 18:15:28,2880,164,26.41,3044,40,3084,10903,28.29,1,1,12,12,六龜區
3441,2020-06-06 18:15:29,60,1,3.95,61,0,61,1520,4.01,1,1,3,3,茂林區
3442,2020-06-06 18:15:29,201,24,6.01,225,2,227,3342,6.79,1,1,8,8,桃源區
3443,2020-06-06 18:15:29,209,7,8.95,216,0,216,2334,9.25,1,1,4,4,那瑪夏區
3444,2020-06-06 18:16:20,938186,25032,40.79,963218,5112,968330,2297941,42.14,38,37,1823,1822,高雄市
3445,2020-06-06 18:16:20,44512,1008,39.24,45520,190,45710,113422,40.3,1,1,77,77,鼓山區
3446,2020-06-06 18:16:20,57508,1416,36.37,58924,271,59195,158116,37.44,1,1,103,103,左營區
3447,2020-06-06 18:16:20,9107,221,43.17,9328,57,9385,21094,44.49,1,1,24,24,鹽埕區
3448,2020-06-06 18:16:21,119407,2870,42.45,122277,561,122838,279241,43.99,1,0,189,188,三民區
3449,2020-06-06 18:16:21,17452,443,40.21,17895,96,17991,43397,41.46,1,1,42,42,新興區
3450,2020-06-06 18:16:21,61389,1623,40.51,63012,283,63295,151524,41.77,1,1,99,99,楠梓區
3451,2020-06-06 18:16:21,9437,252,39.81,9689,47,9736,23704,41.07,1,1,22,22,前金區
3452,2020-06-06 18:16:22,57069,1421,39.98,58490,295,58785,142733,41.19,1,1,116,116,苓雅區
3453,2020-06-06 18:16:22,10658,295,44.49,10953,58,11011,23954,45.97,1,1,18,18,旗津區
3454,2020-06-06 18:16:22,66816,1779,42.48,68595,347,68942,157294,43.83,1,1,119,119,前鎮區
3455,2020-06-06 18:16:23,55361,1415,42.72,56776,259,57035,129597,44.01,1,1,89,89,小港區
3456,2020-06-06 18:16:23,117795,3062,40.06,120857,617,121474,294083,41.31,1,1,228,228,鳳山區
3457,2020-06-06 18:16:23,25028,684,43.44,25712,194,25906,57617,44.96,1,1,51,51,林園區
3458,2020-06-06 18:16:24,13320,363,45.49,13683,89,13772,29282,47.03,1,1,24,24,大社區
3459,2020-06-06 18:16:24,15318,389,42.88,15707,89,15796,35719,44.22,1,1,32,32,大樹區
3460,2020-06-06 18:16:24,39474,1029,41.56,40503,222,40725,94987,42.87,1,1,81,81,大寮區
3461,2020-06-06 18:16:25,16662,412,42.76,17074,91,17165,38963,44.05,1,1,28,28,鳥松區
3462,2020-06-06 18:16:25,32084,895,40.55,32979,190,33169,79113,41.93,1,1,72,72,岡山區
3463,2020-06-06 18:16:25,32787,886,44.32,33673,168,33841,73973,45.75,1,1,47,47,仁武區
3464,2020-06-06 18:16:26,16254,507,49.89,16761,95,16856,32578,51.74,1,1,31,31,橋頭區
3465,2020-06-06 18:16:26,10618,306,41.88,10924,91,11015,25354,43.44,1,1,25,25,燕巢區
3466,2020-06-06 18:16:26,2552,92,39.72,2644,21,2665,6425,41.48,1,1,12,12,田寮區
3467,2020-06-06 18:16:27,18054,568,42.55,18622,111,18733,42432,44.15,1,1,41,41,路竹區
3468,2020-06-06 18:16:27,10929,369,43.55,11298,75,11373,25097,45.32,1,1,24,24,湖內區
3469,2020-06-06 18:16:27,10600,315,41.54,10915,59,10974,25515,43.01,1,1,21,21,茄萣區
3470,2020-06-06 18:16:27,10559,281,44.29,10840,70,10910,23841,45.76,1,1,21,21,阿蓮區
3471,2020-06-06 18:16:28,4914,122,42.0,5036,23,5059,11699,43.24,1,1,12,12,永安區
3472,2020-06-06 18:16:28,14032,404,46.35,14436,87,14523,30272,47.98,1,1,28,28,梓官區
3473,2020-06-06 18:16:28,6173,193,38.78,6366,48,6414,15918,40.29,1,1,18,18,彌陀區
3474,2020-06-06 18:16:29,9749,420,28.58,10169,88,10257,34112,30.07,1,1,32,32,美濃區
3475,2020-06-06 18:16:29,11399,474,37.0,11873,78,11951,30807,38.79,1,1,35,35,旗山區
3476,2020-06-06 18:16:30,2733,121,26.69,2854,28,2882,10238,28.15,1,1,10,10,杉林區
3477,2020-06-06 18:16:30,2880,164,26.41,3044,40,3084,10903,28.29,1,1,12,12,六龜區
3478,2020-06-06 18:16:30,1223,56,23.41,1279,16,1295,5224,24.79,1,1,7,7,甲仙區
3479,2020-06-06 18:16:31,60,1,3.95,61,0,61,1520,4.01,1,1,3,3,茂林區
3480,2020-06-06 18:16:31,201,24,6.01,225,2,227,3342,6.79,1,1,8,8,桃源區
3481,2020-06-06 18:16:31,3863,145,30.86,4008,56,4064,12517,32.47,1,1,18,18,內門區
3482,2020-06-06 18:16:32,209,7,8.95,216,0,216,2334,9.25,1,1,4,4,那瑪夏區
3483,2020-06-06 18:17:22,44512,1008,39.24,45520,190,45710,113422,40.3,1,1,77,77,鼓山區
3484,2020-06-06 18:17:22,938186,25032,40.79,963218,5112,968330,2297941,42.14,38,37,1823,1822,高雄市
3485,2020-06-06 18:17:22,57508,1416,36.37,58924,271,59195,158116,37.44,1,1,103,103,左營區
3486,2020-06-06 18:17:22,61389,1623,40.51,63012,283,63295,151524,41.77,1,1,99,99,楠梓區
3487,2020-06-06 18:17:22,9107,221,43.17,9328,57,9385,21094,44.49,1,1,24,24,鹽埕區
3488,2020-06-06 18:17:23,17452,443,40.21,17895,96,17991,43397,41.46,1,1,42,42,新興區
3489,2020-06-06 18:17:23,119407,2870,42.45,122277,561,122838,279241,43.99,1,0,189,188,三民區
3490,2020-06-06 18:17:23,57069,1421,39.98,58490,295,58785,142733,41.19,1,1,116,116,苓雅區
3491,2020-06-06 18:17:23,9437,252,39.81,9689,47,9736,23704,41.07,1,1,22,22,前金區
3492,2020-06-06 18:17:24,25028,684,43.44,25712,194,25906,57617,44.96,1,1,51,51,林園區
3493,2020-06-06 18:17:24,117795,3062,40.06,120857,617,121474,294083,41.31,1,1,228,228,鳳山區
3494,2020-06-06 18:17:24,39474,1029,41.56,40503,222,40725,94987,42.87,1,1,81,81,大寮區
3495,2020-06-06 18:17:24,10658,295,44.49,10953,58,11011,23954,45.97,1,1,18,18,旗津區
3496,2020-06-06 18:17:24,55361,1415,42.72,56776,259,57035,129597,44.01,1,1,89,89,小港區
3497,2020-06-06 18:17:24,66816,1779,42.48,68595,347,68942,157294,43.83,1,1,119,119,前鎮區
3498,2020-06-06 18:17:25,15318,389,42.88,15707,89,15796,35719,44.22,1,1,32,32,大樹區
3499,2020-06-06 18:17:25,16662,412,42.76,17074,91,17165,38963,44.05,1,1,28,28,鳥松區
3500,2020-06-06 18:17:25,32787,886,44.32,33673,168,33841,73973,45.75,1,1,47,47,仁武區
3501,2020-06-06 18:17:25,13320,363,45.49,13683,89,13772,29282,47.03,1,1,24,24,大社區
3502,2020-06-06 18:17:26,6173,193,38.78,6366,48,6414,15918,40.29,1,1,18,18,彌陀區
3503,2020-06-06 18:17:26,4914,122,42.0,5036,23,5059,11699,43.24,1,1,12,12,永安區
3504,2020-06-06 18:17:26,10559,281,44.29,10840,70,10910,23841,45.76,1,1,21,21,阿蓮區
3505,2020-06-06 18:17:26,16254,507,49.89,16761,95,16856,32578,51.74,1,1,31,31,橋頭區
3506,2020-06-06 18:17:26,18054,568,42.55,18622,111,18733,42432,44.15,1,1,41,41,路竹區
3507,2020-06-06 18:17:26,10929,369,43.55,11298,75,11373,25097,45.32,1,1,24,24,湖內區
3508,2020-06-06 18:17:26,10600,315,41.54,10915,59,10974,25515,43.01,1,1,21,21,茄萣區
3509,2020-06-06 18:17:26,32084,895,40.55,32979,190,33169,79113,41.93,1,1,72,72,岡山區
3510,2020-06-06 18:17:26,2552,92,39.72,2644,21,2665,6425,41.48,1,1,12,12,田寮區
3511,2020-06-06 18:17:26,10618,306,41.88,10924,91,11015,25354,43.44,1,1,25,25,燕巢區
3512,2020-06-06 18:17:27,1223,56,23.41,1279,16,1295,5224,24.79,1,1,7,7,甲仙區
3513,2020-06-06 18:17:27,2733,121,26.69,2854,28,2882,10238,28.15,1,1,10,10,杉林區
3514,2020-06-06 18:17:27,2880,164,26.41,3044,40,3084,10903,28.29,1,1,12,12,六龜區
3515,2020-06-06 18:17:27,11399,474,37.0,11873,78,11951,30807,38.79,1,1,35,35,旗山區
3516,2020-06-06 18:17:27,9749,420,28.58,10169,88,10257,34112,30.07,1,1,32,32,美濃區
3517,2020-06-06 18:17:27,3863,145,30.86,4008,56,4064,12517,32.47,1,1,18,18,內門區
3518,2020-06-06 18:17:27,60,1,3.95,61,0,61,1520,4.01,1,1,3,3,茂林區
3519,2020-06-06 18:17:27,201,24,6.01,225,2,227,3342,6.79,1,1,8,8,桃源區
3520,2020-06-06 18:17:27,209,7,8.95,216,0,216,2334,9.25,1,1,4,4,那瑪夏區
3521,2020-06-06 18:17:27,14032,404,46.35,14436,87,14523,30272,47.98,1,1,28,28,梓官區
3522,2020-06-06 18:18:17,9107,221,43.17,9328,57,9385,21094,44.49,1,1,24,24,鹽埕區
3523,2020-06-06 18:18:17,938186,25032,40.79,963218,5112,968330,2297941,42.14,38,37,1823,1822,高雄市
3524,2020-06-06 18:18:18,119407,2870,42.45,122277,561,122838,279241,43.99,1,0,189,188,三民區
3525,2020-06-06 18:18:18,9437,252,39.81,9689,47,9736,23704,41.07,1,1,22,22,前金區
3526,2020-06-06 18:18:18,61389,1623,40.51,63012,283,63295,151524,41.77,1,1,99,99,楠梓區
3527,2020-06-06 18:18:18,44512,1008,39.24,45520,190,45710,113422,40.3,1,1,77,77,鼓山區
3528,2020-06-06 18:18:18,57508,1416,36.37,58924,271,59195,158116,37.44,1,1,103,103,左營區
3529,2020-06-06 18:18:18,17452,443,40.21,17895,96,17991,43397,41.46,1,1,42,42,新興區
3530,2020-06-06 18:18:19,66816,1779,42.48,68595,347,68942,157294,43.83,1,1,119,119,前鎮區
3531,2020-06-06 18:18:19,10658,295,44.49,10953,58,11011,23954,45.97,1,1,18,18,旗津區
3532,2020-06-06 18:18:19,57069,1421,39.98,58490,295,58785,142733,41.19,1,1,116,116,苓雅區
3533,2020-06-06 18:18:20,55361,1415,42.72,56776,259,57035,129597,44.01,1,1,89,89,小港區
3534,2020-06-06 18:18:20,117795,3062,40.06,120857,617,121474,294083,41.31,1,1,228,228,鳳山區
3535,2020-06-06 18:18:21,15318,389,42.88,15707,89,15796,35719,44.22,1,1,32,32,大樹區
3536,2020-06-06 18:18:21,25028,684,43.44,25712,194,25906,57617,44.96,1,1,51,51,林園區
3537,2020-06-06 18:18:21,39474,1029,41.56,40503,222,40725,94987,42.87,1,1,81,81,大寮區
3538,2020-06-06 18:18:22,32787,886,44.32,33673,168,33841,73973,45.75,1,1,47,47,仁武區
3539,2020-06-06 18:18:22,16662,412,42.76,17074,91,17165,38963,44.05,1,1,28,28,鳥松區
3540,2020-06-06 18:18:22,13320,363,45.49,13683,89,13772,29282,47.03,1,1,24,24,大社區
3541,2020-06-06 18:18:23,16254,507,49.89,16761,95,16856,32578,51.74,1,1,31,31,橋頭區
3542,2020-06-06 18:18:23,10618,306,41.88,10924,91,11015,25354,43.44,1,1,25,25,燕巢區
3543,2020-06-06 18:18:23,32084,895,40.55,32979,190,33169,79113,41.93,1,1,72,72,岡山區
3544,2020-06-06 18:18:24,18054,568,42.55,18622,111,18733,42432,44.15,1,1,41,41,路竹區
3545,2020-06-06 18:18:24,10600,315,41.54,10915,59,10974,25515,43.01,1,1,21,21,茄萣區
3546,2020-06-06 18:18:24,10559,281,44.29,10840,70,10910,23841,45.76,1,1,21,21,阿蓮區
3547,2020-06-06 18:18:24,10929,369,43.55,11298,75,11373,25097,45.32,1,1,24,24,湖內區
3548,2020-06-06 18:18:24,2552,92,39.72,2644,21,2665,6425,41.48,1,1,12,12,田寮區
3549,2020-06-06 18:18:25,14032,404,46.35,14436,87,14523,30272,47.98,1,1,28,28,梓官區
3550,2020-06-06 18:18:25,6173,193,38.78,6366,48,6414,15918,40.29,1,1,18,18,彌陀區
3551,2020-06-06 18:18:25,4914,122,42.0,5036,23,5059,11699,43.24,1,1,12,12,永安區
3552,2020-06-06 18:18:26,2880,164,26.41,3044,40,3084,10903,28.29,1,1,12,12,六龜區
3553,2020-06-06 18:18:26,3863,145,30.86,4008,56,4064,12517,32.47,1,1,18,18,內門區
3554,2020-06-06 18:18:26,1223,56,23.41,1279,16,1295,5224,24.79,1,1,7,7,甲仙區
3555,2020-06-06 18:18:26,2733,121,26.69,2854,28,2882,10238,28.15,1,1,10,10,杉林區
3556,2020-06-06 18:18:26,9749,420,28.58,10169,88,10257,34112,30.07,1,1,32,32,美濃區
3557,2020-06-06 18:18:26,11399,474,37.0,11873,78,11951,30807,38.79,1,1,35,35,旗山區
3558,2020-06-06 18:18:27,60,1,3.95,61,0,61,1520,4.01,1,1,3,3,茂林區
3559,2020-06-06 18:18:27,201,24,6.01,225,2,227,3342,6.79,1,1,8,8,桃源區
3560,2020-06-06 18:18:27,209,7,8.95,216,0,216,2334,9.25,1,1,4,4,那瑪夏區
3561,2020-06-06 18:19:17,938186,25032,40.79,963218,5112,968330,2297941,42.14,38,37,1823,1822,高雄市
3562,2020-06-06 18:19:17,57508,1416,36.37,58924,271,59195,158116,37.44,1,1,103,103,左營區
3563,2020-06-06 18:19:17,44512,1008,39.24,45520,190,45710,113422,40.3,1,1,77,77,鼓山區
3564,2020-06-06 18:19:17,9107,221,43.17,9328,57,9385,21094,44.49,1,1,24,24,鹽埕區
3565,2020-06-06 18:19:18,61389,1623,40.51,63012,283,63295,151524,41.77,1,1,99,99,楠梓區
3566,2020-06-06 18:19:18,119407,2870,42.45,122277,561,122838,279241,43.99,1,0,189,188,三民區
3567,2020-06-06 18:19:18,17452,443,40.21,17895,96,17991,43397,41.46,1,1,42,42,新興區
3568,2020-06-06 18:19:19,66816,1779,42.48,68595,347,68942,157294,43.83,1,1,119,119,前鎮區
3569,2020-06-06 18:19:19,57069,1421,39.98,58490,295,58785,142733,41.19,1,1,116,116,苓雅區
3570,2020-06-06 18:19:19,25028,684,43.44,25712,194,25906,57617,44.96,1,1,51,51,林園區
3571,2020-06-06 18:19:19,10658,295,44.49,10953,58,11011,23954,45.97,1,1,18,18,旗津區
3572,2020-06-06 18:19:19,55361,1415,42.72,56776,259,57035,129597,44.01,1,1,89,89,小港區
3573,2020-06-06 18:19:19,13320,363,45.49,13683,89,13772,29282,47.03,1,1,24,24,大社區
3574,2020-06-06 18:19:19,9437,252,39.81,9689,47,9736,23704,41.07,1,1,22,22,前金區
3575,2020-06-06 18:19:19,39474,1029,41.56,40503,222,40725,94987,42.87,1,1,81,81,大寮區
3576,2020-06-06 18:19:19,32787,886,44.32,33673,168,33841,73973,45.75,1,1,47,47,仁武區
3577,2020-06-06 18:19:19,15318,389,42.88,15707,89,15796,35719,44.22,1,1,32,32,大樹區
3578,2020-06-06 18:19:19,16662,412,42.76,17074,91,17165,38963,44.05,1,1,28,28,鳥松區
3579,2020-06-06 18:19:19,117795,3062,40.06,120857,617,121474,294083,41.31,1,1,228,228,鳳山區
3580,2020-06-06 18:19:19,32084,895,40.55,32979,190,33169,79113,41.93,1,1,72,72,岡山區
3581,2020-06-06 18:19:20,11399,474,37.0,11873,78,11951,30807,38.79,1,1,35,35,旗山區
3582,2020-06-06 18:19:20,16254,507,49.89,16761,95,16856,32578,51.74,1,1,31,31,橋頭區
3583,2020-06-06 18:19:20,6173,193,38.78,6366,48,6414,15918,40.29,1,1,18,18,彌陀區
3584,2020-06-06 18:19:20,10559,281,44.29,10840,70,10910,23841,45.76,1,1,21,21,阿蓮區
3585,2020-06-06 18:19:20,10929,369,43.55,11298,75,11373,25097,45.32,1,1,24,24,湖內區
3586,2020-06-06 18:19:20,10600,315,41.54,10915,59,10974,25515,43.01,1,1,21,21,茄萣區
3587,2020-06-06 18:19:20,10618,306,41.88,10924,91,11015,25354,43.44,1,1,25,25,燕巢區
3588,2020-06-06 18:19:20,4914,122,42.0,5036,23,5059,11699,43.24,1,1,12,12,永安區
3589,2020-06-06 18:19:20,2552,92,39.72,2644,21,2665,6425,41.48,1,1,12,12,田寮區
3590,2020-06-06 18:19:20,18054,568,42.55,18622,111,18733,42432,44.15,1,1,41,41,路竹區
3591,2020-06-06 18:19:20,14032,404,46.35,14436,87,14523,30272,47.98,1,1,28,28,梓官區
3592,2020-06-06 18:19:21,1223,56,23.41,1279,16,1295,5224,24.79,1,1,7,7,甲仙區
3593,2020-06-06 18:19:21,9749,420,28.58,10169,88,10257,34112,30.07,1,1,32,32,美濃區
3594,2020-06-06 18:19:21,3863,145,30.86,4008,56,4064,12517,32.47,1,1,18,18,內門區
3595,2020-06-06 18:19:21,2880,164,26.41,3044,40,3084,10903,28.29,1,1,12,12,六龜區
3596,2020-06-06 18:19:21,60,1,3.95,61,0,61,1520,4.01,1,1,3,3,茂林區
3597,2020-06-06 18:19:21,2733,121,26.69,2854,28,2882,10238,28.15,1,1,10,10,杉林區
3598,2020-06-06 18:19:22,201,24,6.01,225,2,227,3342,6.79,1,1,8,8,桃源區
3599,2020-06-06 18:19:22,209,7,8.95,216,0,216,2334,9.25,1,1,4,4,那瑪夏區
3600,2020-06-06 18:20:12,44512,1008,39.24,45520,190,45710,113422,40.3,1,1,77,77,鼓山區
3601,2020-06-06 18:20:12,9437,252,39.81,9689,47,9736,23704,41.07,1,1,22,22,前金區
3602,2020-06-06 18:20:12,119407,2870,42.45,122277,561,122838,279241,43.99,1,0,189,188,三民區
3603,2020-06-06 18:20:12,61389,1623,40.51,63012,283,63295,151524,41.77,1,1,99,99,楠梓區
3604,2020-06-06 18:20:12,57508,1416,36.37,58924,271,59195,158116,37.44,1,1,103,103,左營區
3605,2020-06-06 18:20:12,17452,443,40.21,17895,96,17991,43397,41.46,1,1,42,42,新興區
3606,2020-06-06 18:20:12,9107,221,43.17,9328,57,9385,21094,44.49,1,1,24,24,鹽埕區
3607,2020-06-06 18:20:12,938186,25032,40.79,963218,5112,968330,2297941,42.14,38,37,1823,1822,高雄市
3608,2020-06-06 18:20:13,66816,1779,42.48,68595,347,68942,157294,43.83,1,1,119,119,前鎮區
3609,2020-06-06 18:20:13,10658,295,44.49,10953,58,11011,23954,45.97,1,1,18,18,旗津區
3610,2020-06-06 18:20:13,15318,389,42.88,15707,89,15796,35719,44.22,1,1,32,32,大樹區
3611,2020-06-06 18:20:13,55361,1415,42.72,56776,259,57035,129597,44.01,1,1,89,89,小港區
3612,2020-06-06 18:20:13,117795,3062,40.06,120857,617,121474,294083,41.31,1,1,228,228,鳳山區
3613,2020-06-06 18:20:13,57069,1421,39.98,58490,295,58785,142733,41.19,1,1,116,116,苓雅區
3614,2020-06-06 18:20:13,25028,684,43.44,25712,194,25906,57617,44.96,1,1,51,51,林園區
3615,2020-06-06 18:20:13,39474,1029,41.56,40503,222,40725,94987,42.87,1,1,81,81,大寮區
3616,2020-06-06 18:20:14,18054,568,42.55,18622,111,18733,42432,44.15,1,1,41,41,路竹區
3617,2020-06-06 18:20:14,10600,315,41.54,10915,59,10974,25515,43.01,1,1,21,21,茄萣區
3618,2020-06-06 18:20:14,4914,122,42.0,5036,23,5059,11699,43.24,1,1,12,12,永安區
3619,2020-06-06 18:20:14,10559,281,44.29,10840,70,10910,23841,45.76,1,1,21,21,阿蓮區
3620,2020-06-06 18:20:14,13320,363,45.49,13683,89,13772,29282,47.03,1,1,24,24,大社區
3621,2020-06-06 18:20:14,10618,306,41.88,10924,91,11015,25354,43.44,1,1,25,25,燕巢區
3622,2020-06-06 18:20:14,16254,507,49.89,16761,95,16856,32578,51.74,1,1,31,31,橋頭區
3623,2020-06-06 18:20:14,2552,92,39.72,2644,21,2665,6425,41.48,1,1,12,12,田寮區
3624,2020-06-06 18:20:14,16662,412,42.76,17074,91,17165,38963,44.05,1,1,28,28,鳥松區
3625,2020-06-06 18:20:14,32787,886,44.32,33673,168,33841,73973,45.75,1,1,47,47,仁武區
3626,2020-06-06 18:20:14,32084,895,40.55,32979,190,33169,79113,41.93,1,1,72,72,岡山區
3627,2020-06-06 18:20:14,10929,369,43.55,11298,75,11373,25097,45.32,1,1,24,24,湖內區
3628,2020-06-06 18:20:15,11399,474,37.0,11873,78,11951,30807,38.79,1,1,35,35,旗山區
3629,2020-06-06 18:20:15,3863,145,30.86,4008,56,4064,12517,32.47,1,1,18,18,內門區
3630,2020-06-06 18:20:15,1223,56,23.41,1279,16,1295,5224,24.79,1,1,7,7,甲仙區
3631,2020-06-06 18:20:15,14032,404,46.35,14436,87,14523,30272,47.98,1,1,28,28,梓官區
3632,2020-06-06 18:20:15,6173,193,38.78,6366,48,6414,15918,40.29,1,1,18,18,彌陀區
3633,2020-06-06 18:20:15,9749,420,28.58,10169,88,10257,34112,30.07,1,1,32,32,美濃區
3634,2020-06-06 18:20:15,2880,164,26.41,3044,40,3084,10903,28.29,1,1,12,12,六龜區
3635,2020-06-06 18:20:15,2733,121,26.69,2854,28,2882,10238,28.15,1,1,10,10,杉林區
3636,2020-06-06 18:20:15,209,7,8.95,216,0,216,2334,9.25,1,1,4,4,那瑪夏區
3637,2020-06-06 18:20:15,60,1,3.95,61,0,61,1520,4.01,1,1,3,3,茂林區
3638,2020-06-06 18:20:15,201,24,6.01,225,2,227,3342,6.79,1,1,8,8,桃源區
3639,2020-06-06 18:21:07,57508,1416,36.37,58924,271,59195,158116,37.44,1,1,103,103,左營區
3640,2020-06-06 18:21:07,61389,1623,40.51,63012,283,63295,151524,41.77,1,1,99,99,楠梓區
3641,2020-06-06 18:21:07,9107,221,43.17,9328,57,9385,21094,44.49,1,1,24,24,鹽埕區
3642,2020-06-06 18:21:07,119407,2870,42.45,122277,561,122838,279241,43.99,1,0,189,188,三民區
3643,2020-06-06 18:21:07,938186,25032,40.79,963218,5112,968330,2297941,42.14,38,37,1823,1822,高雄市
3644,2020-06-06 18:21:07,17452,443,40.21,17895,96,17991,43397,41.46,1,1,42,42,新興區
3645,2020-06-06 18:21:07,9437,252,39.81,9689,47,9736,23704,41.07,1,1,22,22,前金區
3646,2020-06-06 18:21:07,44512,1008,39.24,45520,190,45710,113422,40.3,1,1,77,77,鼓山區
3647,2020-06-06 18:21:08,10658,295,44.49,10953,58,11011,23954,45.97,1,1,18,18,旗津區
3648,2020-06-06 18:21:08,55361,1415,42.72,56776,259,57035,129597,44.01,1,1,89,89,小港區
3649,2020-06-06 18:21:08,57069,1421,39.98,58490,295,58785,142733,41.19,1,1,116,116,苓雅區
3650,2020-06-06 18:21:08,66816,1779,42.48,68595,347,68942,157294,43.83,1,1,119,119,前鎮區
3651,2020-06-06 18:21:09,25028,684,43.44,25712,194,25906,57617,44.96,1,1,51,51,林園區
3652,2020-06-06 18:21:09,32787,886,44.32,33673,168,33841,73973,45.75,1,1,47,47,仁武區
3653,2020-06-06 18:21:09,117795,3062,40.06,120857,617,121474,294083,41.31,1,1,228,228,鳳山區
3654,2020-06-06 18:21:09,39474,1029,41.56,40503,222,40725,94987,42.87,1,1,81,81,大寮區
3655,2020-06-06 18:21:09,13320,363,45.49,13683,89,13772,29282,47.03,1,1,24,24,大社區
3656,2020-06-06 18:21:09,15318,389,42.88,15707,89,15796,35719,44.22,1,1,32,32,大樹區
3657,2020-06-06 18:21:10,16662,412,42.76,17074,91,17165,38963,44.05,1,1,28,28,鳥松區
3658,2020-06-06 18:21:10,16254,507,49.89,16761,95,16856,32578,51.74,1,1,31,31,橋頭區
3659,2020-06-06 18:21:10,32084,895,40.55,32979,190,33169,79113,41.93,1,1,72,72,岡山區
3660,2020-06-06 18:21:11,10618,306,41.88,10924,91,11015,25354,43.44,1,1,25,25,燕巢區
3661,2020-06-06 18:21:11,10559,281,44.29,10840,70,10910,23841,45.76,1,1,21,21,阿蓮區
3662,2020-06-06 18:21:11,2552,92,39.72,2644,21,2665,6425,41.48,1,1,12,12,田寮區
3663,2020-06-06 18:21:12,18054,568,42.55,18622,111,18733,42432,44.15,1,1,41,41,路竹區
3664,2020-06-06 18:21:12,10929,369,43.55,11298,75,11373,25097,45.32,1,1,24,24,湖內區
3665,2020-06-06 18:21:12,10600,315,41.54,10915,59,10974,25515,43.01,1,1,21,21,茄萣區
3666,2020-06-06 18:21:13,14032,404,46.35,14436,87,14523,30272,47.98,1,1,28,28,梓官區
3667,2020-06-06 18:21:13,4914,122,42.0,5036,23,5059,11699,43.24,1,1,12,12,永安區
3668,2020-06-06 18:21:13,6173,193,38.78,6366,48,6414,15918,40.29,1,1,18,18,彌陀區
3669,2020-06-06 18:21:14,11399,474,37.0,11873,78,11951,30807,38.79,1,1,35,35,旗山區
3670,2020-06-06 18:21:14,2880,164,26.41,3044,40,3084,10903,28.29,1,1,12,12,六龜區
3671,2020-06-06 18:21:14,9749,420,28.58,10169,88,10257,34112,30.07,1,1,32,32,美濃區
3672,2020-06-06 18:21:15,3863,145,30.86,4008,56,4064,12517,32.47,1,1,18,18,內門區
3673,2020-06-06 18:21:15,2733,121,26.69,2854,28,2882,10238,28.15,1,1,10,10,杉林區
3674,2020-06-06 18:21:15,1223,56,23.41,1279,16,1295,5224,24.79,1,1,7,7,甲仙區
3675,2020-06-06 18:21:16,209,7,8.95,216,0,216,2334,9.25,1,1,4,4,那瑪夏區
3676,2020-06-06 18:21:16,60,1,3.95,61,0,61,1520,4.01,1,1,3,3,茂林區
3677,2020-06-06 18:21:16,201,24,6.01,225,2,227,3342,6.79,1,1,8,8,桃源區
3678,2020-06-06 18:22:07,9107,221,43.17,9328,57,9385,21094,44.49,1,1,24,24,鹽埕區
3679,2020-06-06 18:22:07,55361,1415,42.72,56776,259,57035,129597,44.01,1,1,89,89,小港區
3680,2020-06-06 18:22:07,39474,1029,41.56,40503,222,40725,94987,42.87,1,1,81,81,大寮區
3681,2020-06-06 18:22:07,938186,25032,40.79,963218,5112,968330,2297941,42.14,38,37,1823,1822,高雄市
3682,2020-06-06 18:22:07,66816,1779,42.48,68595,347,68942,157294,43.83,1,1,119,119,前鎮區
3683,2020-06-06 18:22:07,119407,2870,42.45,122277,561,122838,279241,43.99,1,0,189,188,三民區
3684,2020-06-06 18:22:07,57508,1416,36.37,58924,271,59195,158116,37.44,1,1,103,103,左營區
3685,2020-06-06 18:22:07,9437,252,39.81,9689,47,9736,23704,41.07,1,1,22,22,前金區
3686,2020-06-06 18:22:07,25028,684,43.44,25712,194,25906,57617,44.96,1,1,51,51,林園區
3687,2020-06-06 18:22:07,117795,3062,40.06,120857,617,121474,294083,41.31,1,1,228,228,鳳山區
3688,2020-06-06 18:22:07,17452,443,40.21,17895,96,17991,43397,41.46,1,1,42,42,新興區
3689,2020-06-06 18:22:07,61389,1623,40.51,63012,283,63295,151524,41.77,1,1,99,99,楠梓區
3690,2020-06-06 18:22:07,57069,1421,39.98,58490,295,58785,142733,41.19,1,1,116,116,苓雅區
3691,2020-06-06 18:22:07,10658,295,44.49,10953,58,11011,23954,45.97,1,1,18,18,旗津區
3692,2020-06-06 18:22:07,44512,1008,39.24,45520,190,45710,113422,40.3,1,1,77,77,鼓山區
3693,2020-06-06 18:22:08,16254,507,49.89,16761,95,16856,32578,51.74,1,1,31,31,橋頭區
3694,2020-06-06 18:22:08,9749,420,28.58,10169,88,10257,34112,30.07,1,1,32,32,美濃區
3695,2020-06-06 18:22:08,10600,315,41.54,10915,59,10974,25515,43.01,1,1,21,21,茄萣區
3696,2020-06-06 18:22:08,6173,193,38.78,6366,48,6414,15918,40.29,1,1,18,18,彌陀區
3697,2020-06-06 18:22:08,32084,895,40.55,32979,190,33169,79113,41.93,1,1,72,72,岡山區
3698,2020-06-06 18:22:08,10929,369,43.55,11298,75,11373,25097,45.32,1,1,24,24,湖內區
3699,2020-06-06 18:22:08,4914,122,42.0,5036,23,5059,11699,43.24,1,1,12,12,永安區
3700,2020-06-06 18:22:08,15318,389,42.88,15707,89,15796,35719,44.22,1,1,32,32,大樹區
3701,2020-06-06 18:22:08,13320,363,45.49,13683,89,13772,29282,47.03,1,1,24,24,大社區
3702,2020-06-06 18:22:08,32787,886,44.32,33673,168,33841,73973,45.75,1,1,47,47,仁武區
3703,2020-06-06 18:22:08,11399,474,37.0,11873,78,11951,30807,38.79,1,1,35,35,旗山區
3704,2020-06-06 18:22:08,10618,306,41.88,10924,91,11015,25354,43.44,1,1,25,25,燕巢區
3705,2020-06-06 18:22:08,18054,568,42.55,18622,111,18733,42432,44.15,1,1,41,41,路竹區
3706,2020-06-06 18:22:08,14032,404,46.35,14436,87,14523,30272,47.98,1,1,28,28,梓官區
3707,2020-06-06 18:22:08,10559,281,44.29,10840,70,10910,23841,45.76,1,1,21,21,阿蓮區
3708,2020-06-06 18:22:08,16662,412,42.76,17074,91,17165,38963,44.05,1,1,28,28,鳥松區
3709,2020-06-06 18:22:08,2552,92,39.72,2644,21,2665,6425,41.48,1,1,12,12,田寮區
3710,2020-06-06 18:22:09,2880,164,26.41,3044,40,3084,10903,28.29,1,1,12,12,六龜區
3711,2020-06-06 18:22:09,201,24,6.01,225,2,227,3342,6.79,1,1,8,8,桃源區
3712,2020-06-06 18:22:09,60,1,3.95,61,0,61,1520,4.01,1,1,3,3,茂林區
3713,2020-06-06 18:22:09,3863,145,30.86,4008,56,4064,12517,32.47,1,1,18,18,內門區
3714,2020-06-06 18:22:09,2733,121,26.69,2854,28,2882,10238,28.15,1,1,10,10,杉林區
3715,2020-06-06 18:22:09,209,7,8.95,216,0,216,2334,9.25,1,1,4,4,那瑪夏區
3716,2020-06-06 18:22:09,1223,56,23.41,1279,16,1295,5224,24.79,1,1,7,7,甲仙區
3717,2020-06-06 18:22:59,61389,1623,40.51,63012,283,63295,151524,41.77,1,1,99,99,楠梓區
3718,2020-06-06 18:22:59,57508,1416,36.37,58924,271,59195,158116,37.44,1,1,103,103,左營區
3719,2020-06-06 18:22:59,938186,25032,40.79,963218,5112,968330,2297941,42.14,38,37,1823,1822,高雄市
3720,2020-06-06 18:22:59,9107,221,43.17,9328,57,9385,21094,44.49,1,1,24,24,鹽埕區
3721,2020-06-06 18:22:59,44512,1008,39.24,45520,190,45710,113422,40.3,1,1,77,77,鼓山區
3722,2020-06-06 18:22:59,119407,2870,42.45,122277,561,122838,279241,43.99,1,0,189,188,三民區
3723,2020-06-06 18:23:00,57069,1421,39.98,58490,295,58785,142733,41.19,1,1,116,116,苓雅區
3724,2020-06-06 18:23:00,66816,1779,42.48,68595,347,68942,157294,43.83,1,1,119,119,前鎮區
3725,2020-06-06 18:23:00,9437,252,39.81,9689,47,9736,23704,41.07,1,1,22,22,前金區
3726,2020-06-06 18:23:00,17452,443,40.21,17895,96,17991,43397,41.46,1,1,42,42,新興區
3727,2020-06-06 18:23:01,55361,1415,42.72,56776,259,57035,129597,44.01,1,1,89,89,小港區
3728,2020-06-06 18:23:01,25028,684,43.44,25712,194,25906,57617,44.96,1,1,51,51,林園區
3729,2020-06-06 18:23:01,117795,3062,40.06,120857,617,121474,294083,41.31,1,1,228,228,鳳山區
3730,2020-06-06 18:23:01,39474,1029,41.56,40503,222,40725,94987,42.87,1,1,81,81,大寮區
3731,2020-06-06 18:23:01,10658,295,44.49,10953,58,11011,23954,45.97,1,1,18,18,旗津區
3732,2020-06-06 18:23:02,15318,389,42.88,15707,89,15796,35719,44.22,1,1,32,32,大樹區
3733,2020-06-06 18:23:02,13320,363,45.49,13683,89,13772,29282,47.03,1,1,24,24,大社區
3734,2020-06-06 18:23:02,32787,886,44.32,33673,168,33841,73973,45.75,1,1,47,47,仁武區
3735,2020-06-06 18:23:03,32084,895,40.55,32979,190,33169,79113,41.93,1,1,72,72,岡山區
3736,2020-06-06 18:23:03,16254,507,49.89,16761,95,16856,32578,51.74,1,1,31,31,橋頭區
3737,2020-06-06 18:23:03,16662,412,42.76,17074,91,17165,38963,44.05,1,1,28,28,鳥松區
3738,2020-06-06 18:23:03,10618,306,41.88,10924,91,11015,25354,43.44,1,1,25,25,燕巢區
3739,2020-06-06 18:23:04,18054,568,42.55,18622,111,18733,42432,44.15,1,1,41,41,路竹區
3740,2020-06-06 18:23:04,10929,369,43.55,11298,75,11373,25097,45.32,1,1,24,24,湖內區
3741,2020-06-06 18:23:04,2552,92,39.72,2644,21,2665,6425,41.48,1,1,12,12,田寮區
3742,2020-06-06 18:23:04,10559,281,44.29,10840,70,10910,23841,45.76,1,1,21,21,阿蓮區
3743,2020-06-06 18:23:05,11399,474,37.0,11873,78,11951,30807,38.79,1,1,35,35,旗山區
3744,2020-06-06 18:23:05,14032,404,46.35,14436,87,14523,30272,47.98,1,1,28,28,梓官區
3745,2020-06-06 18:23:05,4914,122,42.0,5036,23,5059,11699,43.24,1,1,12,12,永安區
3746,2020-06-06 18:23:05,10600,315,41.54,10915,59,10974,25515,43.01,1,1,21,21,茄萣區
3747,2020-06-06 18:23:05,6173,193,38.78,6366,48,6414,15918,40.29,1,1,18,18,彌陀區
3748,2020-06-06 18:23:06,2880,164,26.41,3044,40,3084,10903,28.29,1,1,12,12,六龜區
3749,2020-06-06 18:23:06,2733,121,26.69,2854,28,2882,10238,28.15,1,1,10,10,杉林區
3750,2020-06-06 18:23:06,1223,56,23.41,1279,16,1295,5224,24.79,1,1,7,7,甲仙區
3751,2020-06-06 18:23:06,9749,420,28.58,10169,88,10257,34112,30.07,1,1,32,32,美濃區
3752,2020-06-06 18:23:07,209,7,8.95,216,0,216,2334,9.25,1,1,4,4,那瑪夏區
3753,2020-06-06 18:23:07,201,24,6.01,225,2,227,3342,6.79,1,1,8,8,桃源區
3754,2020-06-06 18:23:07,60,1,3.95,61,0,61,1520,4.01,1,1,3,3,茂林區
3755,2020-06-06 18:23:07,3863,145,30.86,4008,56,4064,12517,32.47,1,1,18,18,內門區
3756,2020-06-06 18:23:57,938186,25032,40.79,963218,5112,968330,2297941,42.14,38,37,1823,1822,高雄市
3757,2020-06-06 18:23:58,119407,2870,42.45,122277,561,122838,279241,43.99,1,0,189,188,三民區
3758,2020-06-06 18:23:58,57508,1416,36.37,58924,271,59195,158116,37.44,1,1,103,103,左營區
3759,2020-06-06 18:23:58,9437,252,39.81,9689,47,9736,23704,41.07,1,1,22,22,前金區
3760,2020-06-06 18:23:58,17452,443,40.21,17895,96,17991,43397,41.46,1,1,42,42,新興區
3761,2020-06-06 18:23:58,61389,1623,40.51,63012,283,63295,151524,41.77,1,1,99,99,楠梓區
3762,2020-06-06 18:23:58,44512,1008,39.24,45520,190,45710,113422,40.3,1,1,77,77,鼓山區
3763,2020-06-06 18:23:58,9107,221,43.17,9328,57,9385,21094,44.49,1,1,24,24,鹽埕區
3764,2020-06-06 18:23:59,55361,1415,42.72,56776,259,57035,129597,44.01,1,1,89,89,小港區
3765,2020-06-06 18:23:59,57069,1421,39.98,58490,295,58785,142733,41.19,1,1,116,116,苓雅區
3766,2020-06-06 18:23:59,117795,3062,40.06,120857,617,121474,294083,41.31,1,1,228,228,鳳山區
3767,2020-06-06 18:23:59,10658,295,44.49,10953,58,11011,23954,45.97,1,1,18,18,旗津區
3768,2020-06-06 18:23:59,66816,1779,42.48,68595,347,68942,157294,43.83,1,1,119,119,前鎮區
3769,2020-06-06 18:24:00,16254,507,49.89,16761,95,16856,32578,51.74,1,1,31,31,橋頭區
3770,2020-06-06 18:24:00,2552,92,39.72,2644,21,2665,6425,41.48,1,1,12,12,田寮區
3771,2020-06-06 18:24:00,32084,895,40.55,32979,190,33169,79113,41.93,1,1,72,72,岡山區
3772,2020-06-06 18:24:00,39474,1029,41.56,40503,222,40725,94987,42.87,1,1,81,81,大寮區
3773,2020-06-06 18:24:00,32787,886,44.32,33673,168,33841,73973,45.75,1,1,47,47,仁武區
3774,2020-06-06 18:24:00,10618,306,41.88,10924,91,11015,25354,43.44,1,1,25,25,燕巢區
3775,2020-06-06 18:24:00,25028,684,43.44,25712,194,25906,57617,44.96,1,1,51,51,林園區
3776,2020-06-06 18:24:00,15318,389,42.88,15707,89,15796,35719,44.22,1,1,32,32,大樹區
3777,2020-06-06 18:24:00,10559,281,44.29,10840,70,10910,23841,45.76,1,1,21,21,阿蓮區
3778,2020-06-06 18:24:00,13320,363,45.49,13683,89,13772,29282,47.03,1,1,24,24,大社區
3779,2020-06-06 18:24:00,16662,412,42.76,17074,91,17165,38963,44.05,1,1,28,28,鳥松區
3780,2020-06-06 18:24:01,3863,145,30.86,4008,56,4064,12517,32.47,1,1,18,18,內門區
3781,2020-06-06 18:24:01,1223,56,23.41,1279,16,1295,5224,24.79,1,1,7,7,甲仙區
3782,2020-06-06 18:24:01,6173,193,38.78,6366,48,6414,15918,40.29,1,1,18,18,彌陀區
3783,2020-06-06 18:24:01,9749,420,28.58,10169,88,10257,34112,30.07,1,1,32,32,美濃區
3784,2020-06-06 18:24:01,4914,122,42.0,5036,23,5059,11699,43.24,1,1,12,12,永安區
3785,2020-06-06 18:24:01,2880,164,26.41,3044,40,3084,10903,28.29,1,1,12,12,六龜區
3786,2020-06-06 18:24:01,14032,404,46.35,14436,87,14523,30272,47.98,1,1,28,28,梓官區
3787,2020-06-06 18:24:01,2733,121,26.69,2854,28,2882,10238,28.15,1,1,10,10,杉林區
3788,2020-06-06 18:24:01,11399,474,37.0,11873,78,11951,30807,38.79,1,1,35,35,旗山區
3789,2020-06-06 18:24:01,18054,568,42.55,18622,111,18733,42432,44.15,1,1,41,41,路竹區
3790,2020-06-06 18:24:01,10600,315,41.54,10915,59,10974,25515,43.01,1,1,21,21,茄萣區
3791,2020-06-06 18:24:01,10929,369,43.55,11298,75,11373,25097,45.32,1,1,24,24,湖內區
3792,2020-06-06 18:24:02,201,24,6.01,225,2,227,3342,6.79,1,1,8,8,桃源區
3793,2020-06-06 18:24:02,209,7,8.95,216,0,216,2334,9.25,1,1,4,4,那瑪夏區
3794,2020-06-06 18:24:02,60,1,3.95,61,0,61,1520,4.01,1,1,3,3,茂林區
3795,2020-06-06 18:24:52,938186,25032,40.79,963218,5112,968330,2297941,42.14,38,37,1823,1822,高雄市
3796,2020-06-06 18:24:52,44512,1008,39.24,45520,190,45710,113422,40.3,1,1,77,77,鼓山區
3797,2020-06-06 18:24:52,9107,221,43.17,9328,57,9385,21094,44.49,1,1,24,24,鹽埕區
3798,2020-06-06 18:24:53,9437,252,39.81,9689,47,9736,23704,41.07,1,1,22,22,前金區
3799,2020-06-06 18:24:53,17452,443,40.21,17895,96,17991,43397,41.46,1,1,42,42,新興區
3800,2020-06-06 18:24:53,119407,2870,42.45,122277,561,122838,279241,43.99,1,0,189,188,三民區
3801,2020-06-06 18:24:53,55361,1415,42.72,56776,259,57035,129597,44.01,1,1,89,89,小港區
3802,2020-06-06 18:24:53,57069,1421,39.98,58490,295,58785,142733,41.19,1,1,116,116,苓雅區
3803,2020-06-06 18:24:53,57508,1416,36.37,58924,271,59195,158116,37.44,1,1,103,103,左營區
3804,2020-06-06 18:24:53,61389,1623,40.51,63012,283,63295,151524,41.77,1,1,99,99,楠梓區
3805,2020-06-06 18:24:53,66816,1779,42.48,68595,347,68942,157294,43.83,1,1,119,119,前鎮區
3806,2020-06-06 18:24:53,10658,295,44.49,10953,58,11011,23954,45.97,1,1,18,18,旗津區
3807,2020-06-06 18:24:54,32084,895,40.55,32979,190,33169,79113,41.93,1,1,72,72,岡山區
3808,2020-06-06 18:24:54,2552,92,39.72,2644,21,2665,6425,41.48,1,1,12,12,田寮區
3809,2020-06-06 18:24:54,16254,507,49.89,16761,95,16856,32578,51.74,1,1,31,31,橋頭區
3810,2020-06-06 18:24:54,10618,306,41.88,10924,91,11015,25354,43.44,1,1,25,25,燕巢區
3811,2020-06-06 18:24:54,117795,3062,40.06,120857,617,121474,294083,41.31,1,1,228,228,鳳山區
3812,2020-06-06 18:24:54,25028,684,43.44,25712,194,25906,57617,44.96,1,1,51,51,林園區
3813,2020-06-06 18:24:54,13320,363,45.49,13683,89,13772,29282,47.03,1,1,24,24,大社區
3814,2020-06-06 18:24:54,16662,412,42.76,17074,91,17165,38963,44.05,1,1,28,28,鳥松區
3815,2020-06-06 18:24:54,39474,1029,41.56,40503,222,40725,94987,42.87,1,1,81,81,大寮區
3816,2020-06-06 18:24:54,15318,389,42.88,15707,89,15796,35719,44.22,1,1,32,32,大樹區
3817,2020-06-06 18:24:54,32787,886,44.32,33673,168,33841,73973,45.75,1,1,47,47,仁武區
3818,2020-06-06 18:24:55,4914,122,42.0,5036,23,5059,11699,43.24,1,1,12,12,永安區
3819,2020-06-06 18:24:55,6173,193,38.78,6366,48,6414,15918,40.29,1,1,18,18,彌陀區
3820,2020-06-06 18:24:55,10929,369,43.55,11298,75,11373,25097,45.32,1,1,24,24,湖內區
3821,2020-06-06 18:24:55,10600,315,41.54,10915,59,10974,25515,43.01,1,1,21,21,茄萣區
3822,2020-06-06 18:24:55,18054,568,42.55,18622,111,18733,42432,44.15,1,1,41,41,路竹區
3823,2020-06-06 18:24:55,10559,281,44.29,10840,70,10910,23841,45.76,1,1,21,21,阿蓮區
3824,2020-06-06 18:24:56,2880,164,26.41,3044,40,3084,10903,28.29,1,1,12,12,六龜區
3825,2020-06-06 18:24:56,9749,420,28.58,10169,88,10257,34112,30.07,1,1,32,32,美濃區
3826,2020-06-06 18:24:56,11399,474,37.0,11873,78,11951,30807,38.79,1,1,35,35,旗山區
3827,2020-06-06 18:24:56,14032,404,46.35,14436,87,14523,30272,47.98,1,1,28,28,梓官區
3828,2020-06-06 18:24:56,1223,56,23.41,1279,16,1295,5224,24.79,1,1,7,7,甲仙區
3829,2020-06-06 18:24:57,3863,145,30.86,4008,56,4064,12517,32.47,1,1,18,18,內門區
3830,2020-06-06 18:24:57,60,1,3.95,61,0,61,1520,4.01,1,1,3,3,茂林區
3831,2020-06-06 18:24:57,201,24,6.01,225,2,227,3342,6.79,1,1,8,8,桃源區
3832,2020-06-06 18:24:57,2733,121,26.69,2854,28,2882,10238,28.15,1,1,10,10,杉林區
3833,2020-06-06 18:24:58,209,7,8.95,216,0,216,2334,9.25,1,1,4,4,那瑪夏區
3834,2020-06-06 18:25:48,9107,221,43.17,9328,57,9385,21094,44.49,1,1,24,24,鹽埕區
3835,2020-06-06 18:25:48,44512,1008,39.24,45520,190,45710,113422,40.3,1,1,77,77,鼓山區
3836,2020-06-06 18:25:48,119407,2870,42.45,122277,561,122838,279241,43.99,1,0,189,188,三民區
3837,2020-06-06 18:25:48,938186,25032,40.79,963218,5112,968330,2297941,42.14,38,37,1823,1822,高雄市
3838,2020-06-06 18:25:48,61389,1623,40.51,63012,283,63295,151524,41.77,1,1,99,99,楠梓區
3839,2020-06-06 18:25:48,57508,1416,36.37,58924,271,59195,158116,37.44,1,1,103,103,左營區
3840,2020-06-06 18:25:49,25028,684,43.44,25712,194,25906,57617,44.96,1,1,51,51,林園區
3841,2020-06-06 18:25:49,117795,3062,40.06,120857,617,121474,294083,41.31,1,1,228,228,鳳山區
3842,2020-06-06 18:25:49,17452,443,40.21,17895,96,17991,43397,41.46,1,1,42,42,新興區
3843,2020-06-06 18:25:49,55361,1415,42.72,56776,259,57035,129597,44.01,1,1,89,89,小港區
3844,2020-06-06 18:25:49,57069,1421,39.98,58490,295,58785,142733,41.19,1,1,116,116,苓雅區
3845,2020-06-06 18:25:49,9437,252,39.81,9689,47,9736,23704,41.07,1,1,22,22,前金區
3846,2020-06-06 18:25:49,66816,1779,42.48,68595,347,68942,157294,43.83,1,1,119,119,前鎮區
3847,2020-06-06 18:25:49,10658,295,44.49,10953,58,11011,23954,45.97,1,1,18,18,旗津區
3848,2020-06-06 18:25:50,15318,389,42.88,15707,89,15796,35719,44.22,1,1,32,32,大樹區
3849,2020-06-06 18:25:50,39474,1029,41.56,40503,222,40725,94987,42.87,1,1,81,81,大寮區
3850,2020-06-06 18:25:51,13320,363,45.49,13683,89,13772,29282,47.03,1,1,24,24,大社區
3851,2020-06-06 18:25:51,32084,895,40.55,32979,190,33169,79113,41.93,1,1,72,72,岡山區
3852,2020-06-06 18:25:51,10618,306,41.88,10924,91,11015,25354,43.44,1,1,25,25,燕巢區
3853,2020-06-06 18:25:51,16662,412,42.76,17074,91,17165,38963,44.05,1,1,28,28,鳥松區
3854,2020-06-06 18:25:51,32787,886,44.32,33673,168,33841,73973,45.75,1,1,47,47,仁武區
3855,2020-06-06 18:25:51,16254,507,49.89,16761,95,16856,32578,51.74,1,1,31,31,橋頭區
3856,2020-06-06 18:25:52,10559,281,44.29,10840,70,10910,23841,45.76,1,1,21,21,阿蓮區
3857,2020-06-06 18:25:52,10929,369,43.55,11298,75,11373,25097,45.32,1,1,24,24,湖內區
3858,2020-06-06 18:25:52,10600,315,41.54,10915,59,10974,25515,43.01,1,1,21,21,茄萣區
3859,2020-06-06 18:25:52,18054,568,42.55,18622,111,18733,42432,44.15,1,1,41,41,路竹區
3860,2020-06-06 18:25:52,2552,92,39.72,2644,21,2665,6425,41.48,1,1,12,12,田寮區
3861,2020-06-06 18:25:53,2880,164,26.41,3044,40,3084,10903,28.29,1,1,12,12,六龜區
3862,2020-06-06 18:25:53,11399,474,37.0,11873,78,11951,30807,38.79,1,1,35,35,旗山區
3863,2020-06-06 18:25:53,2733,121,26.69,2854,28,2882,10238,28.15,1,1,10,10,杉林區
3864,2020-06-06 18:25:53,1223,56,23.41,1279,16,1295,5224,24.79,1,1,7,7,甲仙區
3865,2020-06-06 18:25:53,6173,193,38.78,6366,48,6414,15918,40.29,1,1,18,18,彌陀區
3866,2020-06-06 18:25:53,4914,122,42.0,5036,23,5059,11699,43.24,1,1,12,12,永安區
3867,2020-06-06 18:25:53,9749,420,28.58,10169,88,10257,34112,30.07,1,1,32,32,美濃區
3868,2020-06-06 18:25:53,14032,404,46.35,14436,87,14523,30272,47.98,1,1,28,28,梓官區
3869,2020-06-06 18:25:54,209,7,8.95,216,0,216,2334,9.25,1,1,4,4,那瑪夏區
3870,2020-06-06 18:25:54,201,24,6.01,225,2,227,3342,6.79,1,1,8,8,桃源區
3871,2020-06-06 18:25:54,3863,145,30.86,4008,56,4064,12517,32.47,1,1,18,18,內門區
3872,2020-06-06 18:25:54,60,1,3.95,61,0,61,1520,4.01,1,1,3,3,茂林區
3873,2020-06-06 18:26:44,9107,221,43.17,9328,57,9385,21094,44.49,1,1,24,24,鹽埕區
3874,2020-06-06 18:26:44,938186,25032,40.79,963218,5112,968330,2297941,42.14,38,37,1823,1822,高雄市
3875,2020-06-06 18:26:44,44512,1008,39.24,45520,190,45710,113422,40.3,1,1,77,77,鼓山區
3876,2020-06-06 18:26:45,57069,1421,39.98,58490,295,58785,142733,41.19,1,1,116,116,苓雅區
3877,2020-06-06 18:26:45,61389,1623,40.51,63012,283,63295,151524,41.77,1,1,99,99,楠梓區
3878,2020-06-06 18:26:45,55361,1415,42.72,56776,259,57035,129597,44.01,1,1,89,89,小港區
3879,2020-06-06 18:26:45,25028,684,43.44,25712,194,25906,57617,44.96,1,1,51,51,林園區
3880,2020-06-06 18:26:45,17452,443,40.21,17895,96,17991,43397,41.46,1,1,42,42,新興區
3881,2020-06-06 18:26:45,39474,1029,41.56,40503,222,40725,94987,42.87,1,1,81,81,大寮區
3882,2020-06-06 18:26:45,57508,1416,36.37,58924,271,59195,158116,37.44,1,1,103,103,左營區
3883,2020-06-06 18:26:45,117795,3062,40.06,120857,617,121474,294083,41.31,1,1,228,228,鳳山區
3884,2020-06-06 18:26:45,119407,2870,42.45,122277,561,122838,279241,43.99,1,0,189,188,三民區
3885,2020-06-06 18:26:45,66816,1779,42.48,68595,347,68942,157294,43.83,1,1,119,119,前鎮區
3886,2020-06-06 18:26:45,10658,295,44.49,10953,58,11011,23954,45.97,1,1,18,18,旗津區
3887,2020-06-06 18:26:45,9437,252,39.81,9689,47,9736,23704,41.07,1,1,22,22,前金區
3888,2020-06-06 18:26:46,16662,412,42.76,17074,91,17165,38963,44.05,1,1,28,28,鳥松區
3889,2020-06-06 18:26:46,13320,363,45.49,13683,89,13772,29282,47.03,1,1,24,24,大社區
3890,2020-06-06 18:26:46,2552,92,39.72,2644,21,2665,6425,41.48,1,1,12,12,田寮區
3891,2020-06-06 18:26:46,15318,389,42.88,15707,89,15796,35719,44.22,1,1,32,32,大樹區
3892,2020-06-06 18:26:46,32787,886,44.32,33673,168,33841,73973,45.75,1,1,47,47,仁武區
3893,2020-06-06 18:26:46,32084,895,40.55,32979,190,33169,79113,41.93,1,1,72,72,岡山區
3894,2020-06-06 18:26:46,10618,306,41.88,10924,91,11015,25354,43.44,1,1,25,25,燕巢區
3895,2020-06-06 18:26:46,16254,507,49.89,16761,95,16856,32578,51.74,1,1,31,31,橋頭區
3896,2020-06-06 18:26:47,10559,281,44.29,10840,70,10910,23841,45.76,1,1,21,21,阿蓮區
3897,2020-06-06 18:26:47,18054,568,42.55,18622,111,18733,42432,44.15,1,1,41,41,路竹區
3898,2020-06-06 18:26:47,10929,369,43.55,11298,75,11373,25097,45.32,1,1,24,24,湖內區
3899,2020-06-06 18:26:48,3863,145,30.86,4008,56,4064,12517,32.47,1,1,18,18,內門區
3900,2020-06-06 18:26:48,10600,315,41.54,10915,59,10974,25515,43.01,1,1,21,21,茄萣區
3901,2020-06-06 18:26:48,2733,121,26.69,2854,28,2882,10238,28.15,1,1,10,10,杉林區
3902,2020-06-06 18:26:48,2880,164,26.41,3044,40,3084,10903,28.29,1,1,12,12,六龜區
3903,2020-06-06 18:26:48,4914,122,42.0,5036,23,5059,11699,43.24,1,1,12,12,永安區
3904,2020-06-06 18:26:48,11399,474,37.0,11873,78,11951,30807,38.79,1,1,35,35,旗山區
3905,2020-06-06 18:26:48,6173,193,38.78,6366,48,6414,15918,40.29,1,1,18,18,彌陀區
3906,2020-06-06 18:26:48,9749,420,28.58,10169,88,10257,34112,30.07,1,1,32,32,美濃區
3907,2020-06-06 18:26:48,14032,404,46.35,14436,87,14523,30272,47.98,1,1,28,28,梓官區
3908,2020-06-06 18:26:48,1223,56,23.41,1279,16,1295,5224,24.79,1,1,7,7,甲仙區
3909,2020-06-06 18:26:49,201,24,6.01,225,2,227,3342,6.79,1,1,8,8,桃源區
3910,2020-06-06 18:26:49,60,1,3.95,61,0,61,1520,4.01,1,1,3,3,茂林區
3911,2020-06-06 18:26:49,209,7,8.95,216,0,216,2334,9.25,1,1,4,4,那瑪夏區
3912,2020-06-06 18:27:39,10658,295,44.49,10953,58,11011,23954,45.97,1,1,18,18,旗津區
3913,2020-06-06 18:27:39,9437,252,39.81,9689,47,9736,23704,41.07,1,1,22,22,前金區
3914,2020-06-06 18:27:39,9107,221,43.17,9328,57,9385,21094,44.49,1,1,24,24,鹽埕區
3915,2020-06-06 18:27:39,44512,1008,39.24,45520,190,45710,113422,40.3,1,1,77,77,鼓山區
3916,2020-06-06 18:27:39,66816,1779,42.48,68595,347,68942,157294,43.83,1,1,119,119,前鎮區
3917,2020-06-06 18:27:39,57508,1416,36.37,58924,271,59195,158116,37.44,1,1,103,103,左營區
3918,2020-06-06 18:27:39,119407,2870,42.45,122277,561,122838,279241,43.99,1,0,189,188,三民區
3919,2020-06-06 18:27:39,57069,1421,39.98,58490,295,58785,142733,41.19,1,1,116,116,苓雅區
3920,2020-06-06 18:27:39,938186,25032,40.79,963218,5112,968330,2297941,42.14,38,37,1823,1822,高雄市
3921,2020-06-06 18:27:39,17452,443,40.21,17895,96,17991,43397,41.46,1,1,42,42,新興區
3922,2020-06-06 18:27:39,61389,1623,40.51,63012,283,63295,151524,41.77,1,1,99,99,楠梓區
3923,2020-06-06 18:27:40,16254,507,49.89,16761,95,16856,32578,51.74,1,1,31,31,橋頭區
3924,2020-06-06 18:27:40,32084,895,40.55,32979,190,33169,79113,41.93,1,1,72,72,岡山區
3925,2020-06-06 18:27:40,117795,3062,40.06,120857,617,121474,294083,41.31,1,1,228,228,鳳山區
3926,2020-06-06 18:27:40,32787,886,44.32,33673,168,33841,73973,45.75,1,1,47,47,仁武區
3927,2020-06-06 18:27:40,16662,412,42.76,17074,91,17165,38963,44.05,1,1,28,28,鳥松區
3928,2020-06-06 18:27:40,10618,306,41.88,10924,91,11015,25354,43.44,1,1,25,25,燕巢區
3929,2020-06-06 18:27:40,15318,389,42.88,15707,89,15796,35719,44.22,1,1,32,32,大樹區
3930,2020-06-06 18:27:40,2552,92,39.72,2644,21,2665,6425,41.48,1,1,12,12,田寮區
3931,2020-06-06 18:27:40,10559,281,44.29,10840,70,10910,23841,45.76,1,1,21,21,阿蓮區
3932,2020-06-06 18:27:40,55361,1415,42.72,56776,259,57035,129597,44.01,1,1,89,89,小港區
3933,2020-06-06 18:27:40,25028,684,43.44,25712,194,25906,57617,44.96,1,1,51,51,林園區
3934,2020-06-06 18:27:40,13320,363,45.49,13683,89,13772,29282,47.03,1,1,24,24,大社區
3935,2020-06-06 18:27:40,39474,1029,41.56,40503,222,40725,94987,42.87,1,1,81,81,大寮區
3936,2020-06-06 18:27:41,4914,122,42.0,5036,23,5059,11699,43.24,1,1,12,12,永安區
3937,2020-06-06 18:27:41,18054,568,42.55,18622,111,18733,42432,44.15,1,1,41,41,路竹區
3938,2020-06-06 18:27:41,10600,315,41.54,10915,59,10974,25515,43.01,1,1,21,21,茄萣區
3939,2020-06-06 18:27:41,14032,404,46.35,14436,87,14523,30272,47.98,1,1,28,28,梓官區
3940,2020-06-06 18:27:41,10929,369,43.55,11298,75,11373,25097,45.32,1,1,24,24,湖內區
3941,2020-06-06 18:27:41,6173,193,38.78,6366,48,6414,15918,40.29,1,1,18,18,彌陀區
3942,2020-06-06 18:27:42,11399,474,37.0,11873,78,11951,30807,38.79,1,1,35,35,旗山區
3943,2020-06-06 18:27:42,2880,164,26.41,3044,40,3084,10903,28.29,1,1,12,12,六龜區
3944,2020-06-06 18:27:42,9749,420,28.58,10169,88,10257,34112,30.07,1,1,32,32,美濃區
3945,2020-06-06 18:27:43,2733,121,26.69,2854,28,2882,10238,28.15,1,1,10,10,杉林區
3946,2020-06-06 18:27:43,201,24,6.01,225,2,227,3342,6.79,1,1,8,8,桃源區
3947,2020-06-06 18:27:43,1223,56,23.41,1279,16,1295,5224,24.79,1,1,7,7,甲仙區
3948,2020-06-06 18:27:43,3863,145,30.86,4008,56,4064,12517,32.47,1,1,18,18,內門區
3949,2020-06-06 18:27:43,60,1,3.95,61,0,61,1520,4.01,1,1,3,3,茂林區
3950,2020-06-06 18:27:44,209,7,8.95,216,0,216,2334,9.25,1,1,4,4,那瑪夏區
3951,2020-06-06 18:28:34,938186,25032,40.79,963218,5112,968330,2297941,42.14,38,37,1823,1822,高雄市
3952,2020-06-06 18:28:34,9107,221,43.17,9328,57,9385,21094,44.49,1,1,24,24,鹽埕區
3953,2020-06-06 18:28:34,119407,2870,42.45,122277,561,122838,279241,43.99,1,0,189,188,三民區
3954,2020-06-06 18:28:34,44512,1008,39.24,45520,190,45710,113422,40.3,1,1,77,77,鼓山區
3955,2020-06-06 18:28:34,57508,1416,36.37,58924,271,59195,158116,37.44,1,1,103,103,左營區
3956,2020-06-06 18:28:34,17452,443,40.21,17895,96,17991,43397,41.46,1,1,42,42,新興區
3957,2020-06-06 18:28:34,61389,1623,40.51,63012,283,63295,151524,41.77,1,1,99,99,楠梓區
3958,2020-06-06 18:28:34,9437,252,39.81,9689,47,9736,23704,41.07,1,1,22,22,前金區
3959,2020-06-06 18:28:35,55361,1415,42.72,56776,259,57035,129597,44.01,1,1,89,89,小港區
3960,2020-06-06 18:28:35,57069,1421,39.98,58490,295,58785,142733,41.19,1,1,116,116,苓雅區
3961,2020-06-06 18:28:35,66816,1779,42.48,68595,347,68942,157294,43.83,1,1,119,119,前鎮區
3962,2020-06-06 18:28:35,10658,295,44.49,10953,58,11011,23954,45.97,1,1,18,18,旗津區
3963,2020-06-06 18:28:36,39474,1029,41.56,40503,222,40725,94987,42.87,1,1,81,81,大寮區
3964,2020-06-06 18:28:36,117795,3062,40.06,120857,617,121474,294083,41.31,1,1,228,228,鳳山區
3965,2020-06-06 18:28:36,25028,684,43.44,25712,194,25906,57617,44.96,1,1,51,51,林園區
3966,2020-06-06 18:28:37,15318,389,42.88,15707,89,15796,35719,44.22,1,1,32,32,大樹區
3967,2020-06-06 18:28:37,32787,886,44.32,33673,168,33841,73973,45.75,1,1,47,47,仁武區
3968,2020-06-06 18:28:37,13320,363,45.49,13683,89,13772,29282,47.03,1,1,24,24,大社區
3969,2020-06-06 18:28:38,16254,507,49.89,16761,95,16856,32578,51.74,1,1,31,31,橋頭區
3970,2020-06-06 18:28:38,2552,92,39.72,2644,21,2665,6425,41.48,1,1,12,12,田寮區
3971,2020-06-06 18:28:38,16662,412,42.76,17074,91,17165,38963,44.05,1,1,28,28,鳥松區
3972,2020-06-06 18:28:38,10618,306,41.88,10924,91,11015,25354,43.44,1,1,25,25,燕巢區
3973,2020-06-06 18:28:38,32084,895,40.55,32979,190,33169,79113,41.93,1,1,72,72,岡山區
3974,2020-06-06 18:28:39,10559,281,44.29,10840,70,10910,23841,45.76,1,1,21,21,阿蓮區
3975,2020-06-06 18:28:39,10600,315,41.54,10915,59,10974,25515,43.01,1,1,21,21,茄萣區
3976,2020-06-06 18:28:39,10929,369,43.55,11298,75,11373,25097,45.32,1,1,24,24,湖內區
3977,2020-06-06 18:28:39,18054,568,42.55,18622,111,18733,42432,44.15,1,1,41,41,路竹區
3978,2020-06-06 18:28:39,4914,122,42.0,5036,23,5059,11699,43.24,1,1,12,12,永安區
3979,2020-06-06 18:28:40,2733,121,26.69,2854,28,2882,10238,28.15,1,1,10,10,杉林區
3980,2020-06-06 18:28:40,1223,56,23.41,1279,16,1295,5224,24.79,1,1,7,7,甲仙區
3981,2020-06-06 18:28:40,6173,193,38.78,6366,48,6414,15918,40.29,1,1,18,18,彌陀區
3982,2020-06-06 18:28:40,3863,145,30.86,4008,56,4064,12517,32.47,1,1,18,18,內門區
3983,2020-06-06 18:28:40,2880,164,26.41,3044,40,3084,10903,28.29,1,1,12,12,六龜區
3984,2020-06-06 18:28:40,9749,420,28.58,10169,88,10257,34112,30.07,1,1,32,32,美濃區
3985,2020-06-06 18:28:40,14032,404,46.35,14436,87,14523,30272,47.98,1,1,28,28,梓官區
3986,2020-06-06 18:28:40,11399,474,37.0,11873,78,11951,30807,38.79,1,1,35,35,旗山區
3987,2020-06-06 18:28:41,60,1,3.95,61,0,61,1520,4.01,1,1,3,3,茂林區
3988,2020-06-06 18:28:41,201,24,6.01,225,2,227,3342,6.79,1,1,8,8,桃源區
3989,2020-06-06 18:28:41,209,7,8.95,216,0,216,2334,9.25,1,1,4,4,那瑪夏區
3990,2020-06-06 18:29:32,57508,1416,36.37,58924,271,59195,158116,37.44,1,1,103,103,左營區
3991,2020-06-06 18:29:32,57069,1421,39.98,58490,295,58785,142733,41.19,1,1,116,116,苓雅區
3992,2020-06-06 18:29:32,17452,443,40.21,17895,96,17991,43397,41.46,1,1,42,42,新興區
3993,2020-06-06 18:29:32,9107,221,43.17,9328,57,9385,21094,44.49,1,1,24,24,鹽埕區
3994,2020-06-06 18:29:32,61389,1623,40.51,63012,283,63295,151524,41.77,1,1,99,99,楠梓區
3995,2020-06-06 18:29:32,9437,252,39.81,9689,47,9736,23704,41.07,1,1,22,22,前金區
3996,2020-06-06 18:29:32,44512,1008,39.24,45520,190,45710,113422,40.3,1,1,77,77,鼓山區
3997,2020-06-06 18:29:32,66816,1779,42.48,68595,347,68942,157294,43.83,1,1,119,119,前鎮區
3998,2020-06-06 18:29:32,119407,2870,42.45,122277,561,122838,279241,43.99,1,0,189,188,三民區
3999,2020-06-06 18:29:32,938186,25032,40.79,963218,5112,968330,2297941,42.14,38,37,1823,1822,高雄市
4000,2020-06-06 18:29:33,25028,684,43.44,25712,194,25906,57617,44.96,1,1,51,51,林園區
4001,2020-06-06 18:29:33,13320,363,45.49,13683,89,13772,29282,47.03,1,1,24,24,大社區
4002,2020-06-06 18:29:33,2552,92,39.72,2644,21,2665,6425,41.48,1,1,12,12,田寮區
4003,2020-06-06 18:29:33,16662,412,42.76,17074,91,17165,38963,44.05,1,1,28,28,鳥松區
4004,2020-06-06 18:29:33,39474,1029,41.56,40503,222,40725,94987,42.87,1,1,81,81,大寮區
4005,2020-06-06 18:29:33,55361,1415,42.72,56776,259,57035,129597,44.01,1,1,89,89,小港區
4006,2020-06-06 18:29:33,15318,389,42.88,15707,89,15796,35719,44.22,1,1,32,32,大樹區
4007,2020-06-06 18:29:33,10658,295,44.49,10953,58,11011,23954,45.97,1,1,18,18,旗津區
4008,2020-06-06 18:29:33,32084,895,40.55,32979,190,33169,79113,41.93,1,1,72,72,岡山區
4009,2020-06-06 18:29:33,10618,306,41.88,10924,91,11015,25354,43.44,1,1,25,25,燕巢區
4010,2020-06-06 18:29:33,117795,3062,40.06,120857,617,121474,294083,41.31,1,1,228,228,鳳山區
4011,2020-06-06 18:29:33,32787,886,44.32,33673,168,33841,73973,45.75,1,1,47,47,仁武區
4012,2020-06-06 18:29:33,16254,507,49.89,16761,95,16856,32578,51.74,1,1,31,31,橋頭區
4013,2020-06-06 18:29:34,6173,193,38.78,6366,48,6414,15918,40.29,1,1,18,18,彌陀區
4014,2020-06-06 18:29:34,18054,568,42.55,18622,111,18733,42432,44.15,1,1,41,41,路竹區
4015,2020-06-06 18:29:34,10559,281,44.29,10840,70,10910,23841,45.76,1,1,21,21,阿蓮區
4016,2020-06-06 18:29:34,10929,369,43.55,11298,75,11373,25097,45.32,1,1,24,24,湖內區
4017,2020-06-06 18:29:34,4914,122,42.0,5036,23,5059,11699,43.24,1,1,12,12,永安區
4018,2020-06-06 18:29:34,11399,474,37.0,11873,78,11951,30807,38.79,1,1,35,35,旗山區
4019,2020-06-06 18:29:34,14032,404,46.35,14436,87,14523,30272,47.98,1,1,28,28,梓官區
4020,2020-06-06 18:29:34,10600,315,41.54,10915,59,10974,25515,43.01,1,1,21,21,茄萣區
4021,2020-06-06 18:29:35,201,24,6.01,225,2,227,3342,6.79,1,1,8,8,桃源區
4022,2020-06-06 18:29:35,1223,56,23.41,1279,16,1295,5224,24.79,1,1,7,7,甲仙區
4023,2020-06-06 18:29:35,9749,420,28.58,10169,88,10257,34112,30.07,1,1,32,32,美濃區
4024,2020-06-06 18:29:35,209,7,8.95,216,0,216,2334,9.25,1,1,4,4,那瑪夏區
4025,2020-06-06 18:29:35,60,1,3.95,61,0,61,1520,4.01,1,1,3,3,茂林區
4026,2020-06-06 18:29:35,2733,121,26.69,2854,28,2882,10238,28.15,1,1,10,10,杉林區
4027,2020-06-06 18:29:35,2880,164,26.41,3044,40,3084,10903,28.29,1,1,12,12,六龜區
4028,2020-06-06 18:29:35,3863,145,30.86,4008,56,4064,12517,32.47,1,1,18,18,內門區
4029,2020-06-06 18:30:25,938186,25032,40.79,963218,5112,968330,2297941,42.14,38,37,1823,1822,高雄市
4030,2020-06-06 18:30:26,9437,252,39.81,9689,47,9736,23704,41.07,1,1,22,22,前金區
4031,2020-06-06 18:30:26,44512,1008,39.24,45520,190,45710,113422,40.3,1,1,77,77,鼓山區
4032,2020-06-06 18:30:26,17452,443,40.21,17895,96,17991,43397,41.46,1,1,42,42,新興區
4033,2020-06-06 18:30:26,9107,221,43.17,9328,57,9385,21094,44.49,1,1,24,24,鹽埕區
4034,2020-06-06 18:30:26,61389,1623,40.51,63012,283,63295,151524,41.77,1,1,99,99,楠梓區
4035,2020-06-06 18:30:26,119407,2870,42.45,122277,561,122838,279241,43.99,1,0,189,188,三民區
4036,2020-06-06 18:30:26,57508,1416,36.37,58924,271,59195,158116,37.44,1,1,103,103,左營區
4037,2020-06-06 18:30:27,10658,295,44.49,10953,58,11011,23954,45.97,1,1,18,18,旗津區
4038,2020-06-06 18:30:27,66816,1779,42.48,68595,347,68942,157294,43.83,1,1,119,119,前鎮區
4039,2020-06-06 18:30:27,57069,1421,39.98,58490,295,58785,142733,41.19,1,1,116,116,苓雅區
4040,2020-06-06 18:30:28,55361,1415,42.72,56776,259,57035,129597,44.01,1,1,89,89,小港區
4041,2020-06-06 18:30:28,25028,684,43.44,25712,194,25906,57617,44.96,1,1,51,51,林園區
4042,2020-06-06 18:30:28,117795,3062,40.06,120857,617,121474,294083,41.31,1,1,228,228,鳳山區
4043,2020-06-06 18:30:29,39474,1029,41.56,40503,222,40725,94987,42.87,1,1,81,81,大寮區
4044,2020-06-06 18:30:29,15318,389,42.88,15707,89,15796,35719,44.22,1,1,32,32,大樹區
4045,2020-06-06 18:30:30,16254,507,49.89,16761,95,16856,32578,51.74,1,1,31,31,橋頭區
4046,2020-06-06 18:30:30,32787,886,44.32,33673,168,33841,73973,45.75,1,1,47,47,仁武區
4047,2020-06-06 18:30:30,13320,363,45.49,13683,89,13772,29282,47.03,1,1,24,24,大社區
4048,2020-06-06 18:30:30,2552,92,39.72,2644,21,2665,6425,41.48,1,1,12,12,田寮區
4049,2020-06-06 18:30:30,32084,895,40.55,32979,190,33169,79113,41.93,1,1,72,72,岡山區
4050,2020-06-06 18:30:30,10618,306,41.88,10924,91,11015,25354,43.44,1,1,25,25,燕巢區
4051,2020-06-06 18:30:30,16662,412,42.76,17074,91,17165,38963,44.05,1,1,28,28,鳥松區
4052,2020-06-06 18:30:31,10600,315,41.54,10915,59,10974,25515,43.01,1,1,21,21,茄萣區
4053,2020-06-06 18:30:31,18054,568,42.55,18622,111,18733,42432,44.15,1,1,41,41,路竹區
4054,2020-06-06 18:30:31,10929,369,43.55,11298,75,11373,25097,45.32,1,1,24,24,湖內區
4055,2020-06-06 18:30:31,6173,193,38.78,6366,48,6414,15918,40.29,1,1,18,18,彌陀區
4056,2020-06-06 18:30:31,14032,404,46.35,14436,87,14523,30272,47.98,1,1,28,28,梓官區
4057,2020-06-06 18:30:31,4914,122,42.0,5036,23,5059,11699,43.24,1,1,12,12,永安區
4058,2020-06-06 18:30:31,10559,281,44.29,10840,70,10910,23841,45.76,1,1,21,21,阿蓮區
4059,2020-06-06 18:30:32,1223,56,23.41,1279,16,1295,5224,24.79,1,1,7,7,甲仙區
4060,2020-06-06 18:30:32,2733,121,26.69,2854,28,2882,10238,28.15,1,1,10,10,杉林區
4061,2020-06-06 18:30:32,3863,145,30.86,4008,56,4064,12517,32.47,1,1,18,18,內門區
4062,2020-06-06 18:30:32,2880,164,26.41,3044,40,3084,10903,28.29,1,1,12,12,六龜區
4063,2020-06-06 18:30:32,11399,474,37.0,11873,78,11951,30807,38.79,1,1,35,35,旗山區
4064,2020-06-06 18:30:32,9749,420,28.58,10169,88,10257,34112,30.07,1,1,32,32,美濃區
4065,2020-06-06 18:30:32,201,24,6.01,225,2,227,3342,6.79,1,1,8,8,桃源區
4066,2020-06-06 18:30:32,60,1,3.95,61,0,61,1520,4.01,1,1,3,3,茂林區
4067,2020-06-06 18:30:33,209,7,8.95,216,0,216,2334,9.25,1,1,4,4,那瑪夏區
4068,2020-06-06 18:31:23,57508,1416,36.37,58924,271,59195,158116,37.44,1,1,103,103,左營區
4069,2020-06-06 18:31:23,938186,25032,40.79,963218,5112,968330,2297941,42.14,38,37,1823,1822,高雄市
4070,2020-06-06 18:31:23,9107,221,43.17,9328,57,9385,21094,44.49,1,1,24,24,鹽埕區
4071,2020-06-06 18:31:23,44512,1008,39.24,45520,190,45710,113422,40.3,1,1,77,77,鼓山區
4072,2020-06-06 18:31:24,10658,295,44.49,10953,58,11011,23954,45.97,1,1,18,18,旗津區
4073,2020-06-06 18:31:24,61389,1623,40.51,63012,283,63295,151524,41.77,1,1,99,99,楠梓區
4074,2020-06-06 18:31:24,55361,1415,42.72,56776,259,57035,129597,44.01,1,1,89,89,小港區
4075,2020-06-06 18:31:24,13320,363,45.49,13683,89,13772,29282,47.03,1,1,24,24,大社區
4076,2020-06-06 18:31:24,119407,2870,42.45,122277,561,122838,279241,43.99,1,0,189,188,三民區
4077,2020-06-06 18:31:24,66816,1779,42.48,68595,347,68942,157294,43.83,1,1,119,119,前鎮區
4078,2020-06-06 18:31:24,117795,3062,40.06,120857,617,121474,294083,41.31,1,1,228,228,鳳山區
4079,2020-06-06 18:31:24,32787,886,44.32,33673,168,33841,73973,45.75,1,1,47,47,仁武區
4080,2020-06-06 18:31:24,17452,443,40.21,17895,96,17991,43397,41.46,1,1,42,42,新興區
4081,2020-06-06 18:31:24,57069,1421,39.98,58490,295,58785,142733,41.19,1,1,116,116,苓雅區
4082,2020-06-06 18:31:24,9437,252,39.81,9689,47,9736,23704,41.07,1,1,22,22,前金區
4083,2020-06-06 18:31:24,15318,389,42.88,15707,89,15796,35719,44.22,1,1,32,32,大樹區
4084,2020-06-06 18:31:24,39474,1029,41.56,40503,222,40725,94987,42.87,1,1,81,81,大寮區
4085,2020-06-06 18:31:24,25028,684,43.44,25712,194,25906,57617,44.96,1,1,51,51,林園區
4086,2020-06-06 18:31:25,2552,92,39.72,2644,21,2665,6425,41.48,1,1,12,12,田寮區
4087,2020-06-06 18:31:25,16254,507,49.89,16761,95,16856,32578,51.74,1,1,31,31,橋頭區
4088,2020-06-06 18:31:25,32084,895,40.55,32979,190,33169,79113,41.93,1,1,72,72,岡山區
4089,2020-06-06 18:31:25,10618,306,41.88,10924,91,11015,25354,43.44,1,1,25,25,燕巢區
4090,2020-06-06 18:31:25,16662,412,42.76,17074,91,17165,38963,44.05,1,1,28,28,鳥松區
4091,2020-06-06 18:31:26,10600,315,41.54,10915,59,10974,25515,43.01,1,1,21,21,茄萣區
4092,2020-06-06 18:31:26,4914,122,42.0,5036,23,5059,11699,43.24,1,1,12,12,永安區
4093,2020-06-06 18:31:26,11399,474,37.0,11873,78,11951,30807,38.79,1,1,35,35,旗山區
4094,2020-06-06 18:31:26,18054,568,42.55,18622,111,18733,42432,44.15,1,1,41,41,路竹區
4095,2020-06-06 18:31:26,6173,193,38.78,6366,48,6414,15918,40.29,1,1,18,18,彌陀區
4096,2020-06-06 18:31:26,14032,404,46.35,14436,87,14523,30272,47.98,1,1,28,28,梓官區
4097,2020-06-06 18:31:26,10559,281,44.29,10840,70,10910,23841,45.76,1,1,21,21,阿蓮區
4098,2020-06-06 18:31:26,10929,369,43.55,11298,75,11373,25097,45.32,1,1,24,24,湖內區
4099,2020-06-06 18:31:27,2880,164,26.41,3044,40,3084,10903,28.29,1,1,12,12,六龜區
4100,2020-06-06 18:31:27,9749,420,28.58,10169,88,10257,34112,30.07,1,1,32,32,美濃區
4101,2020-06-06 18:31:27,1223,56,23.41,1279,16,1295,5224,24.79,1,1,7,7,甲仙區
4102,2020-06-06 18:31:28,2733,121,26.69,2854,28,2882,10238,28.15,1,1,10,10,杉林區
4103,2020-06-06 18:31:28,60,1,3.95,61,0,61,1520,4.01,1,1,3,3,茂林區
4104,2020-06-06 18:31:28,3863,145,30.86,4008,56,4064,12517,32.47,1,1,18,18,內門區
4105,2020-06-06 18:31:29,209,7,8.95,216,0,216,2334,9.25,1,1,4,4,那瑪夏區
4106,2020-06-06 18:31:29,201,24,6.01,225,2,227,3342,6.79,1,1,8,8,桃源區
4107,2020-06-06 18:32:19,57508,1416,36.37,58924,271,59195,158116,37.44,1,1,103,103,左營區
4108,2020-06-06 18:32:19,119407,2870,42.45,122277,561,122838,279241,43.99,1,0,189,188,三民區
4109,2020-06-06 18:32:19,57069,1421,39.98,58490,295,58785,142733,41.19,1,1,116,116,苓雅區
4110,2020-06-06 18:32:19,17452,443,40.21,17895,96,17991,43397,41.46,1,1,42,42,新興區
4111,2020-06-06 18:32:19,66816,1779,42.48,68595,347,68942,157294,43.83,1,1,119,119,前鎮區
4112,2020-06-06 18:32:19,9107,221,43.17,9328,57,9385,21094,44.49,1,1,24,24,鹽埕區
4113,2020-06-06 18:32:19,61389,1623,40.51,63012,283,63295,151524,41.77,1,1,99,99,楠梓區
4114,2020-06-06 18:32:19,938186,25032,40.79,963218,5112,968330,2297941,42.14,38,37,1823,1822,高雄市
4115,2020-06-06 18:32:19,9437,252,39.81,9689,47,9736,23704,41.07,1,1,22,22,前金區
4116,2020-06-06 18:32:19,44512,1008,39.24,45520,190,45710,113422,40.3,1,1,77,77,鼓山區
4117,2020-06-06 18:32:20,13320,363,45.49,13683,89,13772,29282,47.03,1,1,24,24,大社區
4118,2020-06-06 18:32:20,39474,1029,41.56,40503,222,40725,94987,42.87,1,1,81,81,大寮區
4119,2020-06-06 18:32:20,10658,295,44.49,10953,58,11011,23954,45.97,1,1,18,18,旗津區
4120,2020-06-06 18:32:20,15318,389,42.88,15707,89,15796,35719,44.22,1,1,32,32,大樹區
4121,2020-06-06 18:32:20,16662,412,42.76,17074,91,17165,38963,44.05,1,1,28,28,鳥松區
4122,2020-06-06 18:32:20,117795,3062,40.06,120857,617,121474,294083,41.31,1,1,228,228,鳳山區
4123,2020-06-06 18:32:20,55361,1415,42.72,56776,259,57035,129597,44.01,1,1,89,89,小港區
4124,2020-06-06 18:32:20,25028,684,43.44,25712,194,25906,57617,44.96,1,1,51,51,林園區
4125,2020-06-06 18:32:20,32787,886,44.32,33673,168,33841,73973,45.75,1,1,47,47,仁武區
4126,2020-06-06 18:32:21,4914,122,42.0,5036,23,5059,11699,43.24,1,1,12,12,永安區
4127,2020-06-06 18:32:21,10618,306,41.88,10924,91,11015,25354,43.44,1,1,25,25,燕巢區
4128,2020-06-06 18:32:21,32084,895,40.55,32979,190,33169,79113,41.93,1,1,72,72,岡山區
4129,2020-06-06 18:32:21,18054,568,42.55,18622,111,18733,42432,44.15,1,1,41,41,路竹區
4130,2020-06-06 18:32:21,16254,507,49.89,16761,95,16856,32578,51.74,1,1,31,31,橋頭區
4131,2020-06-06 18:32:21,10929,369,43.55,11298,75,11373,25097,45.32,1,1,24,24,湖內區
4132,2020-06-06 18:32:21,2552,92,39.72,2644,21,2665,6425,41.48,1,1,12,12,田寮區
4133,2020-06-06 18:32:21,10559,281,44.29,10840,70,10910,23841,45.76,1,1,21,21,阿蓮區
4134,2020-06-06 18:32:21,14032,404,46.35,14436,87,14523,30272,47.98,1,1,28,28,梓官區
4135,2020-06-06 18:32:21,6173,193,38.78,6366,48,6414,15918,40.29,1,1,18,18,彌陀區
4136,2020-06-06 18:32:21,10600,315,41.54,10915,59,10974,25515,43.01,1,1,21,21,茄萣區
4137,2020-06-06 18:32:22,209,7,8.95,216,0,216,2334,9.25,1,1,4,4,那瑪夏區
4138,2020-06-06 18:32:22,60,1,3.95,61,0,61,1520,4.01,1,1,3,3,茂林區
4139,2020-06-06 18:32:22,2880,164,26.41,3044,40,3084,10903,28.29,1,1,12,12,六龜區
4140,2020-06-06 18:32:22,9749,420,28.58,10169,88,10257,34112,30.07,1,1,32,32,美濃區
4141,2020-06-06 18:32:22,3863,145,30.86,4008,56,4064,12517,32.47,1,1,18,18,內門區
4142,2020-06-06 18:32:22,2733,121,26.69,2854,28,2882,10238,28.15,1,1,10,10,杉林區
4143,2020-06-06 18:32:22,11399,474,37.0,11873,78,11951,30807,38.79,1,1,35,35,旗山區
4144,2020-06-06 18:32:22,201,24,6.01,225,2,227,3342,6.79,1,1,8,8,桃源區
4145,2020-06-06 18:32:22,1223,56,23.41,1279,16,1295,5224,24.79,1,1,7,7,甲仙區
4146,2020-06-06 18:33:13,17452,443,40.21,17895,96,17991,43397,41.46,1,1,42,42,新興區
4147,2020-06-06 18:33:13,938186,25032,40.79,963218,5112,968330,2297941,42.14,38,37,1823,1822,高雄市
4148,2020-06-06 18:33:13,9437,252,39.81,9689,47,9736,23704,41.07,1,1,22,22,前金區
4149,2020-06-06 18:33:13,61389,1623,40.51,63012,283,63295,151524,41.77,1,1,99,99,楠梓區
4150,2020-06-06 18:33:13,44512,1008,39.24,45520,190,45710,113422,40.3,1,1,77,77,鼓山區
4151,2020-06-06 18:33:13,57508,1416,36.37,58924,271,59195,158116,37.44,1,1,103,103,左營區
4152,2020-06-06 18:33:13,119407,2870,42.45,122277,561,122838,279241,43.99,1,0,189,188,三民區
4153,2020-06-06 18:33:13,57069,1421,39.98,58490,295,58785,142733,41.19,1,1,116,116,苓雅區
4154,2020-06-06 18:33:13,9107,221,43.17,9328,57,9385,21094,44.49,1,1,24,24,鹽埕區
4155,2020-06-06 18:33:14,66816,1779,42.48,68595,347,68942,157294,43.83,1,1,119,119,前鎮區
4156,2020-06-06 18:33:15,10658,295,44.49,10953,58,11011,23954,45.97,1,1,18,18,旗津區
4157,2020-06-06 18:33:15,55361,1415,42.72,56776,259,57035,129597,44.01,1,1,89,89,小港區
4158,2020-06-06 18:33:15,117795,3062,40.06,120857,617,121474,294083,41.31,1,1,228,228,鳳山區
4159,2020-06-06 18:33:16,25028,684,43.44,25712,194,25906,57617,44.96,1,1,51,51,林園區
4160,2020-06-06 18:33:16,39474,1029,41.56,40503,222,40725,94987,42.87,1,1,81,81,大寮區
4161,2020-06-06 18:33:17,15318,389,42.88,15707,89,15796,35719,44.22,1,1,32,32,大樹區
4162,2020-06-06 18:33:17,13320,363,45.49,13683,89,13772,29282,47.03,1,1,24,24,大社區
4163,2020-06-06 18:33:18,32787,886,44.32,33673,168,33841,73973,45.75,1,1,47,47,仁武區
4164,2020-06-06 18:33:19,16254,507,49.89,16761,95,16856,32578,51.74,1,1,31,31,橋頭區
4165,2020-06-06 18:33:19,32084,895,40.55,32979,190,33169,79113,41.93,1,1,72,72,岡山區
4166,2020-06-06 18:33:19,16662,412,42.76,17074,91,17165,38963,44.05,1,1,28,28,鳥松區
4167,2020-06-06 18:33:20,18054,568,42.55,18622,111,18733,42432,44.15,1,1,41,41,路竹區
4168,2020-06-06 18:33:20,2552,92,39.72,2644,21,2665,6425,41.48,1,1,12,12,田寮區
4169,2020-06-06 18:33:20,10618,306,41.88,10924,91,11015,25354,43.44,1,1,25,25,燕巢區
4170,2020-06-06 18:33:20,10559,281,44.29,10840,70,10910,23841,45.76,1,1,21,21,阿蓮區
4171,2020-06-06 18:33:21,6173,193,38.78,6366,48,6414,15918,40.29,1,1,18,18,彌陀區
4172,2020-06-06 18:33:21,4914,122,42.0,5036,23,5059,11699,43.24,1,1,12,12,永安區
4173,2020-06-06 18:33:21,10929,369,43.55,11298,75,11373,25097,45.32,1,1,24,24,湖內區
4174,2020-06-06 18:33:21,10600,315,41.54,10915,59,10974,25515,43.01,1,1,21,21,茄萣區
4175,2020-06-06 18:33:22,14032,404,46.35,14436,87,14523,30272,47.98,1,1,28,28,梓官區
4176,2020-06-06 18:33:22,9749,420,28.58,10169,88,10257,34112,30.07,1,1,32,32,美濃區
4177,2020-06-06 18:33:22,11399,474,37.0,11873,78,11951,30807,38.79,1,1,35,35,旗山區
4178,2020-06-06 18:33:23,1223,56,23.41,1279,16,1295,5224,24.79,1,1,7,7,甲仙區
4179,2020-06-06 18:33:23,2880,164,26.41,3044,40,3084,10903,28.29,1,1,12,12,六龜區
4180,2020-06-06 18:33:24,3863,145,30.86,4008,56,4064,12517,32.47,1,1,18,18,內門區
4181,2020-06-06 18:33:24,60,1,3.95,61,0,61,1520,4.01,1,1,3,3,茂林區
4182,2020-06-06 18:33:24,201,24,6.01,225,2,227,3342,6.79,1,1,8,8,桃源區
4183,2020-06-06 18:33:24,2733,121,26.69,2854,28,2882,10238,28.15,1,1,10,10,杉林區
4184,2020-06-06 18:33:25,209,7,8.95,216,0,216,2334,9.25,1,1,4,4,那瑪夏區
4185,2020-06-06 18:34:15,44512,1008,39.24,45520,190,45710,113422,40.3,1,1,77,77,鼓山區
4186,2020-06-06 18:34:15,57508,1416,36.37,58924,271,59195,158116,37.44,1,1,103,103,左營區
4187,2020-06-06 18:34:15,9107,221,43.17,9328,57,9385,21094,44.49,1,1,24,24,鹽埕區
4188,2020-06-06 18:34:15,17452,443,40.21,17895,96,17991,43397,41.46,1,1,42,42,新興區
4189,2020-06-06 18:34:15,9437,252,39.81,9689,47,9736,23704,41.07,1,1,22,22,前金區
4190,2020-06-06 18:34:15,120311,2889,42.77,123200,567,123767,281281,44.0,1,1,189,189,三民區
4191,2020-06-06 18:34:15,61389,1623,40.51,63012,283,63295,151524,41.77,1,1,99,99,楠梓區
4192,2020-06-06 18:34:15,939090,25051,40.83,964141,5118,969259,2299981,42.14,38,38,1823,1823,高雄市
4193,2020-06-06 18:34:16,66816,1779,42.48,68595,347,68942,157294,43.83,1,1,119,119,前鎮區
4194,2020-06-06 18:34:16,57069,1421,39.98,58490,295,58785,142733,41.19,1,1,116,116,苓雅區
4195,2020-06-06 18:34:17,39474,1029,41.56,40503,222,40725,94987,42.87,1,1,81,81,大寮區
4196,2020-06-06 18:34:17,10658,295,44.49,10953,58,11011,23954,45.97,1,1,18,18,旗津區
4197,2020-06-06 18:34:17,117795,3062,40.06,120857,617,121474,294083,41.31,1,1,228,228,鳳山區
4198,2020-06-06 18:34:17,25028,684,43.44,25712,194,25906,57617,44.96,1,1,51,51,林園區
4199,2020-06-06 18:34:17,55361,1415,42.72,56776,259,57035,129597,44.01,1,1,89,89,小港區
4200,2020-06-06 18:34:18,15318,389,42.88,15707,89,15796,35719,44.22,1,1,32,32,大樹區
4201,2020-06-06 18:34:18,13320,363,45.49,13683,89,13772,29282,47.03,1,1,24,24,大社區
4202,2020-06-06 18:34:18,32787,886,44.32,33673,168,33841,73973,45.75,1,1,47,47,仁武區
4203,2020-06-06 18:34:18,16254,507,49.89,16761,95,16856,32578,51.74,1,1,31,31,橋頭區
4204,2020-06-06 18:34:18,16662,412,42.76,17074,91,17165,38963,44.05,1,1,28,28,鳥松區
4205,2020-06-06 18:34:18,32084,895,40.55,32979,190,33169,79113,41.93,1,1,72,72,岡山區
4206,2020-06-06 18:34:19,2552,92,39.72,2644,21,2665,6425,41.48,1,1,12,12,田寮區
4207,2020-06-06 18:34:19,10559,281,44.29,10840,70,10910,23841,45.76,1,1,21,21,阿蓮區
4208,2020-06-06 18:34:19,10618,306,41.88,10924,91,11015,25354,43.44,1,1,25,25,燕巢區
4209,2020-06-06 18:34:20,2880,164,26.41,3044,40,3084,10903,28.29,1,1,12,12,六龜區
4210,2020-06-06 18:34:20,10600,315,41.54,10915,59,10974,25515,43.01,1,1,21,21,茄萣區
4211,2020-06-06 18:34:20,6173,193,38.78,6366,48,6414,15918,40.29,1,1,18,18,彌陀區
4212,2020-06-06 18:34:20,14032,404,46.35,14436,87,14523,30272,47.98,1,1,28,28,梓官區
4213,2020-06-06 18:34:20,201,24,6.01,225,2,227,3342,6.79,1,1,8,8,桃源區
4214,2020-06-06 18:34:20,18054,568,42.55,18622,111,18733,42432,44.15,1,1,41,41,路竹區
4215,2020-06-06 18:34:20,3863,145,30.86,4008,56,4064,12517,32.47,1,1,18,18,內門區
4216,2020-06-06 18:34:20,4914,122,42.0,5036,23,5059,11699,43.24,1,1,12,12,永安區
4217,2020-06-06 18:34:20,60,1,3.95,61,0,61,1520,4.01,1,1,3,3,茂林區
4218,2020-06-06 18:34:20,2733,121,26.69,2854,28,2882,10238,28.15,1,1,10,10,杉林區
4219,2020-06-06 18:34:20,1223,56,23.41,1279,16,1295,5224,24.79,1,1,7,7,甲仙區
4220,2020-06-06 18:34:20,11399,474,37.0,11873,78,11951,30807,38.79,1,1,35,35,旗山區
4221,2020-06-06 18:34:20,10929,369,43.55,11298,75,11373,25097,45.32,1,1,24,24,湖內區
4222,2020-06-06 18:34:20,9749,420,28.58,10169,88,10257,34112,30.07,1,1,32,32,美濃區
4223,2020-06-06 18:34:21,209,7,8.95,216,0,216,2334,9.25,1,1,4,4,那瑪夏區
4224,2020-06-06 18:35:11,57508,1416,36.37,58924,271,59195,158116,37.44,1,1,103,103,左營區
4225,2020-06-06 18:35:11,44512,1008,39.24,45520,190,45710,113422,40.3,1,1,77,77,鼓山區
4226,2020-06-06 18:35:11,9107,221,43.17,9328,57,9385,21094,44.49,1,1,24,24,鹽埕區
4227,2020-06-06 18:35:11,939090,25051,40.83,964141,5118,969259,2299981,42.14,38,38,1823,1823,高雄市
4228,2020-06-06 18:35:12,66816,1779,42.48,68595,347,68942,157294,43.83,1,1,119,119,前鎮區
4229,2020-06-06 18:35:12,61389,1623,40.51,63012,283,63295,151524,41.77,1,1,99,99,楠梓區
4230,2020-06-06 18:35:12,120311,2889,42.77,123200,567,123767,281281,44.0,1,1,189,189,三民區
4231,2020-06-06 18:35:12,57069,1421,39.98,58490,295,58785,142733,41.19,1,1,116,116,苓雅區
4232,2020-06-06 18:35:12,9437,252,39.81,9689,47,9736,23704,41.07,1,1,22,22,前金區
4233,2020-06-06 18:35:12,17452,443,40.21,17895,96,17991,43397,41.46,1,1,42,42,新興區
4234,2020-06-06 18:35:13,32787,886,44.32,33673,168,33841,73973,45.75,1,1,47,47,仁武區
4235,2020-06-06 18:35:13,25028,684,43.44,25712,194,25906,57617,44.96,1,1,51,51,林園區
4236,2020-06-06 18:35:13,10618,306,41.88,10924,91,11015,25354,43.44,1,1,25,25,燕巢區
4237,2020-06-06 18:35:13,10658,295,44.49,10953,58,11011,23954,45.97,1,1,18,18,旗津區
4238,2020-06-06 18:35:13,16254,507,49.89,16761,95,16856,32578,51.74,1,1,31,31,橋頭區
4239,2020-06-06 18:35:13,16662,412,42.76,17074,91,17165,38963,44.05,1,1,28,28,鳥松區
4240,2020-06-06 18:35:13,55361,1415,42.72,56776,259,57035,129597,44.01,1,1,89,89,小港區
4241,2020-06-06 18:35:13,117795,3062,40.06,120857,617,121474,294083,41.31,1,1,228,228,鳳山區
4242,2020-06-06 18:35:13,15318,389,42.88,15707,89,15796,35719,44.22,1,1,32,32,大樹區
4243,2020-06-06 18:35:13,32084,895,40.55,32979,190,33169,79113,41.93,1,1,72,72,岡山區
4244,2020-06-06 18:35:13,13320,363,45.49,13683,89,13772,29282,47.03,1,1,24,24,大社區
4245,2020-06-06 18:35:13,39474,1029,41.56,40503,222,40725,94987,42.87,1,1,81,81,大寮區
4246,2020-06-06 18:35:14,18054,568,42.55,18622,111,18733,42432,44.15,1,1,41,41,路竹區
4247,2020-06-06 18:35:14,10600,315,41.54,10915,59,10974,25515,43.01,1,1,21,21,茄萣區
4248,2020-06-06 18:35:14,2552,92,39.72,2644,21,2665,6425,41.48,1,1,12,12,田寮區
4249,2020-06-06 18:35:14,10929,369,43.55,11298,75,11373,25097,45.32,1,1,24,24,湖內區
4250,2020-06-06 18:35:14,10559,281,44.29,10840,70,10910,23841,45.76,1,1,21,21,阿蓮區
4251,2020-06-06 18:35:15,9749,420,28.58,10169,88,10257,34112,30.07,1,1,32,32,美濃區
4252,2020-06-06 18:35:15,4914,122,42.0,5036,23,5059,11699,43.24,1,1,12,12,永安區
4253,2020-06-06 18:35:15,14032,404,46.35,14436,87,14523,30272,47.98,1,1,28,28,梓官區
4254,2020-06-06 18:35:15,11399,474,37.0,11873,78,11951,30807,38.79,1,1,35,35,旗山區
4255,2020-06-06 18:35:15,2880,164,26.41,3044,40,3084,10903,28.29,1,1,12,12,六龜區
4256,2020-06-06 18:35:15,6173,193,38.78,6366,48,6414,15918,40.29,1,1,18,18,彌陀區
4257,2020-06-06 18:35:15,1223,56,23.41,1279,16,1295,5224,24.79,1,1,7,7,甲仙區
4258,2020-06-06 18:35:16,60,1,3.95,61,0,61,1520,4.01,1,1,3,3,茂林區
4259,2020-06-06 18:35:16,3863,145,30.86,4008,56,4064,12517,32.47,1,1,18,18,內門區
4260,2020-06-06 18:35:16,201,24,6.01,225,2,227,3342,6.79,1,1,8,8,桃源區
4261,2020-06-06 18:35:16,209,7,8.95,216,0,216,2334,9.25,1,1,4,4,那瑪夏區
4262,2020-06-06 18:35:16,2733,121,26.69,2854,28,2882,10238,28.15,1,1,10,10,杉林區
4263,2020-06-06 18:36:06,44512,1008,39.24,45520,190,45710,113422,40.3,1,1,77,77,鼓山區
4264,2020-06-06 18:36:06,120311,2889,42.77,123200,567,123767,281281,44.0,1,1,189,189,三民區
4265,2020-06-06 18:36:06,9107,221,43.17,9328,57,9385,21094,44.49,1,1,24,24,鹽埕區
4266,2020-06-06 18:36:06,57508,1416,36.37,58924,271,59195,158116,37.44,1,1,103,103,左營區
4267,2020-06-06 18:36:06,61389,1623,40.51,63012,283,63295,151524,41.77,1,1,99,99,楠梓區
4268,2020-06-06 18:36:06,939090,25051,40.83,964141,5118,969259,2299981,42.14,38,38,1823,1823,高雄市
4269,2020-06-06 18:36:07,66816,1779,42.48,68595,347,68942,157294,43.83,1,1,119,119,前鎮區
4270,2020-06-06 18:36:07,25028,684,43.44,25712,194,25906,57617,44.96,1,1,51,51,林園區
4271,2020-06-06 18:36:07,55361,1415,42.72,56776,259,57035,129597,44.01,1,1,89,89,小港區
4272,2020-06-06 18:36:07,117795,3062,40.06,120857,617,121474,294083,41.31,1,1,228,228,鳳山區
4273,2020-06-06 18:36:07,17452,443,40.21,17895,96,17991,43397,41.46,1,1,42,42,新興區
4274,2020-06-06 18:36:07,10658,295,44.49,10953,58,11011,23954,45.97,1,1,18,18,旗津區
4275,2020-06-06 18:36:07,57069,1421,39.98,58490,295,58785,142733,41.19,1,1,116,116,苓雅區
4276,2020-06-06 18:36:07,39474,1029,41.56,40503,222,40725,94987,42.87,1,1,81,81,大寮區
4277,2020-06-06 18:36:07,9437,252,39.81,9689,47,9736,23704,41.07,1,1,22,22,前金區
4278,2020-06-06 18:36:08,16254,507,49.89,16761,95,16856,32578,51.74,1,1,31,31,橋頭區
4279,2020-06-06 18:36:08,16662,412,42.76,17074,91,17165,38963,44.05,1,1,28,28,鳥松區
4280,2020-06-06 18:36:08,13320,363,45.49,13683,89,13772,29282,47.03,1,1,24,24,大社區
4281,2020-06-06 18:36:08,32787,886,44.32,33673,168,33841,73973,45.75,1,1,47,47,仁武區
4282,2020-06-06 18:36:08,15318,389,42.88,15707,89,15796,35719,44.22,1,1,32,32,大樹區
4283,2020-06-06 18:36:08,32084,895,40.55,32979,190,33169,79113,41.93,1,1,72,72,岡山區
4284,2020-06-06 18:36:09,10559,281,44.29,10840,70,10910,23841,45.76,1,1,21,21,阿蓮區
4285,2020-06-06 18:36:09,2552,92,39.72,2644,21,2665,6425,41.48,1,1,12,12,田寮區
4286,2020-06-06 18:36:09,10618,306,41.88,10924,91,11015,25354,43.44,1,1,25,25,燕巢區
4287,2020-06-06 18:36:10,11399,474,37.0,11873,78,11951,30807,38.79,1,1,35,35,旗山區
4288,2020-06-06 18:36:10,9749,420,28.58,10169,88,10257,34112,30.07,1,1,32,32,美濃區
4289,2020-06-06 18:36:10,2880,164,26.41,3044,40,3084,10903,28.29,1,1,12,12,六龜區
4290,2020-06-06 18:36:10,10929,369,43.55,11298,75,11373,25097,45.32,1,1,24,24,湖內區
4291,2020-06-06 18:36:10,1223,56,23.41,1279,16,1295,5224,24.79,1,1,7,7,甲仙區
4292,2020-06-06 18:36:10,14032,404,46.35,14436,87,14523,30272,47.98,1,1,28,28,梓官區
4293,2020-06-06 18:36:10,10600,315,41.54,10915,59,10974,25515,43.01,1,1,21,21,茄萣區
4294,2020-06-06 18:36:10,18054,568,42.55,18622,111,18733,42432,44.15,1,1,41,41,路竹區
4295,2020-06-06 18:36:10,4914,122,42.0,5036,23,5059,11699,43.24,1,1,12,12,永安區
4296,2020-06-06 18:36:10,6173,193,38.78,6366,48,6414,15918,40.29,1,1,18,18,彌陀區
4297,2020-06-06 18:36:11,60,1,3.95,61,0,61,1520,4.01,1,1,3,3,茂林區
4298,2020-06-06 18:36:11,2733,121,26.69,2854,28,2882,10238,28.15,1,1,10,10,杉林區
4299,2020-06-06 18:36:11,201,24,6.01,225,2,227,3342,6.79,1,1,8,8,桃源區
4300,2020-06-06 18:36:11,209,7,8.95,216,0,216,2334,9.25,1,1,4,4,那瑪夏區
4301,2020-06-06 18:36:11,3863,145,30.86,4008,56,4064,12517,32.47,1,1,18,18,內門區
4302,2020-06-06 18:37:01,17452,443,40.21,17895,96,17991,43397,41.46,1,1,42,42,新興區
4303,2020-06-06 18:37:01,44512,1008,39.24,45520,190,45710,113422,40.3,1,1,77,77,鼓山區
4304,2020-06-06 18:37:01,9107,221,43.17,9328,57,9385,21094,44.49,1,1,24,24,鹽埕區
4305,2020-06-06 18:37:01,57508,1416,36.37,58924,271,59195,158116,37.44,1,1,103,103,左營區
4306,2020-06-06 18:37:01,61389,1623,40.51,63012,283,63295,151524,41.77,1,1,99,99,楠梓區
4307,2020-06-06 18:37:01,9437,252,39.81,9689,47,9736,23704,41.07,1,1,22,22,前金區
4308,2020-06-06 18:37:01,939090,25051,40.83,964141,5118,969259,2299981,42.14,38,38,1823,1823,高雄市
4309,2020-06-06 18:37:01,120311,2889,42.77,123200,567,123767,281281,44.0,1,1,189,189,三民區
4310,2020-06-06 18:37:02,32787,886,44.32,33673,168,33841,73973,45.75,1,1,47,47,仁武區
4311,2020-06-06 18:37:02,57069,1421,39.98,58490,295,58785,142733,41.19,1,1,116,116,苓雅區
4312,2020-06-06 18:37:02,13320,363,45.49,13683,89,13772,29282,47.03,1,1,24,24,大社區
4313,2020-06-06 18:37:02,66816,1779,42.48,68595,347,68942,157294,43.83,1,1,119,119,前鎮區
4314,2020-06-06 18:37:02,39474,1029,41.56,40503,222,40725,94987,42.87,1,1,81,81,大寮區
4315,2020-06-06 18:37:02,55361,1415,42.72,56776,259,57035,129597,44.01,1,1,89,89,小港區
4316,2020-06-06 18:37:02,10658,295,44.49,10953,58,11011,23954,45.97,1,1,18,18,旗津區
4317,2020-06-06 18:37:02,117795,3062,40.06,120857,617,121474,294083,41.31,1,1,228,228,鳳山區
4318,2020-06-06 18:37:02,25028,684,43.44,25712,194,25906,57617,44.96,1,1,51,51,林園區
4319,2020-06-06 18:37:02,15318,389,42.88,15707,89,15796,35719,44.22,1,1,32,32,大樹區
4320,2020-06-06 18:37:03,2552,92,39.72,2644,21,2665,6425,41.48,1,1,12,12,田寮區
4321,2020-06-06 18:37:03,32084,895,40.55,32979,190,33169,79113,41.93,1,1,72,72,岡山區
4322,2020-06-06 18:37:03,4914,122,42.0,5036,23,5059,11699,43.24,1,1,12,12,永安區
4323,2020-06-06 18:37:03,11399,474,37.0,11873,78,11951,30807,38.79,1,1,35,35,旗山區
4324,2020-06-06 18:37:03,10559,281,44.29,10840,70,10910,23841,45.76,1,1,21,21,阿蓮區
4325,2020-06-06 18:37:03,6173,193,38.78,6366,48,6414,15918,40.29,1,1,18,18,彌陀區
4326,2020-06-06 18:37:03,10929,369,43.55,11298,75,11373,25097,45.32,1,1,24,24,湖內區
4327,2020-06-06 18:37:03,18054,568,42.55,18622,111,18733,42432,44.15,1,1,41,41,路竹區
4328,2020-06-06 18:37:03,9749,420,28.58,10169,88,10257,34112,30.07,1,1,32,32,美濃區
4329,2020-06-06 18:37:03,14032,404,46.35,14436,87,14523,30272,47.98,1,1,28,28,梓官區
4330,2020-06-06 18:37:03,10600,315,41.54,10915,59,10974,25515,43.01,1,1,21,21,茄萣區
4331,2020-06-06 18:37:03,16254,507,49.89,16761,95,16856,32578,51.74,1,1,31,31,橋頭區
4332,2020-06-06 18:37:03,16662,412,42.76,17074,91,17165,38963,44.05,1,1,28,28,鳥松區
4333,2020-06-06 18:37:03,10618,306,41.88,10924,91,11015,25354,43.44,1,1,25,25,燕巢區
4334,2020-06-06 18:37:04,3863,145,30.86,4008,56,4064,12517,32.47,1,1,18,18,內門區
4335,2020-06-06 18:37:04,201,24,6.01,225,2,227,3342,6.79,1,1,8,8,桃源區
4336,2020-06-06 18:37:04,2733,121,26.69,2854,28,2882,10238,28.15,1,1,10,10,杉林區
4337,2020-06-06 18:37:04,2880,164,26.41,3044,40,3084,10903,28.29,1,1,12,12,六龜區
4338,2020-06-06 18:37:04,209,7,8.95,216,0,216,2334,9.25,1,1,4,4,那瑪夏區
4339,2020-06-06 18:37:04,60,1,3.95,61,0,61,1520,4.01,1,1,3,3,茂林區
4340,2020-06-06 18:37:04,1223,56,23.41,1279,16,1295,5224,24.79,1,1,7,7,甲仙區
